Date of logging it: 2021-02-05T21:51:15 (by the time in UA).
-------
[10701-10800]
подстрекательство --- подстрекательство, побуждение, поощрение
подсуждаюсь --- бываю приговорен к наказанию
подсуждение --- притворство, лицемерство
подседети --- сидеть ниже кого-л., быть ниже кого-л.
подтверждение --- подтверждение, 2. подстава
подтворятися --- поступать притворно, притворяться
подтомити --- удручить, утомить
подточилие --- поддон, подставляемый под виноградное точило
подточильник --- сосуд, куда стекает выжимаемый сок
подтроние --- отходное место, ретирада
подтесняти --- мучить, угнетать
подуметися --- догадываться
подуститель --- подстрекатель
подустительница --- подстрекательница
подустити --- подстрекать, побуждать, подучить, научить
подущатель --- побуждающий к чему-л.
подчревие --- подчревие
подъемлю --- поднимаю, предпринимаю, подвергаю себя
подклад --- потник под седлом
поднет --- трут
подъяремник --- тягловый скот
подъяремничий --- рабочему скоту принадлежащий
подъяремный --- ярмо носящий
подьячие --- чиновники древней Руси
поделание --- работа, дело
поединщики --- искусные воины, сражавшиеся один на один перед началом общей битвы
поелику --- потому что
поемлю --- беру с собой, отвожу в сторону, жалуюсь, обвиняю
пождание --- ожидание, откладывание на потом
пожданно --- в ожидании, в чаянии
пождателен --- ждущий, медлящий
пожеление --- скорбь, жалость
поженити --- следовать, провожать, гоняться
пожен --- который жал на поле
поженный --- луговой, сенокосный
поживление --- пища, поддерживающая жизнь человека
пожинаем --- которого жнут, или жать можно
пожировати --- водвориться, избрать жилищем, ложем, покоищем
пожитки --- имущество, пожитки
пожрати --- принести в жертву, погубить, поглотить
позавидити --- завидовать, говорить дурно, клеветать
позариться --- польститься
позвиздание --- осмеяние, освистание
позвиздати --- освистать, 2. кликнуть, позвать свистом
позвысковати --- сжиматься, стягиваться (о змее)
познаватися --- ознакомиться, 2. быть узнанным
познаваю --- совокупляюсь с супругом (супругой)
позобати --- склевать, съесть (о птицах), набить зоб
позоб --- пошлина, подать
позоратай --- разведчик, лазутчик, 2. исследователь, испытатель
позоритель --- зритель забавных зрелищ, игрищ, 2. соглядатай, лазутчик, шпион
позорити --- зрителем быть, 2. позорить, срамить, бесчестить
позорица --- актриса, комедиантка
позорище --- зрелище, ристалище, цирк
позороватися --- быть предметом зрелища
позорствовати --- показывать зрителям
позорующий --- зритель
позрение --- зрение, взор
позыбнутися --- пошатнуться, поколебаться
поима --- обвинение, упрёк, укоризна
поимати --- хватать, поймать, 2. жениться, 3. обещать, представлять
поиматься --- вступаться
поищет --- отомстить
покавати --- выковывать
показание --- повод, причина, пример
показнити --- наказать, научить
показнь --- наказание, наука
покалипсь --- Апокалипсис
покаяльный --- покаянный
покаяние --- таинство покаяния, исповедь
поквасити --- смочить, оросить
покладати --- полагать, класть на что-л.
покладеж --- заклад, поклажа
поклажай --- кладовая, хранилище
покланяти колена --- встать на колени, преклонить колени
покланяти главу --- кланяться
поклеп --- ложный оговор
поклисарь --- посол
поклонительный --- назначенный для поклонения, относящийся к поклонению
поклонитися --- приветствовать, поклониться, уважать, благоговеть
поклон --- поклон
поклоняние --- поклонение
поклоп --- крышка, покрышка
поклати --- злословить, хулить, порицать
покова --- с того времени как
покоин --- тропари, стихиры и каноны с молениями об усопших
мертвен --- тропари, стихиры и каноны с молениями об усопших
покоище --- покой, почивание
покон --- начало, 2. закон, правило
поконоколенник --- родоначальник колена
покопатися --- вскопанным быть, возделанным, обрытым
покора --- покорность, раскаяние
покорение --- усмирение, послушание, покорность
покосный --- удобный, благоприятный
покрестие --- крестный ход
покрещевати --- крестить в другой раз
покриву --- несправедливо, ложно, против совести


-------
Number of things where an exception was: 10752, 10753, 10777
Date of logging it: 2021-02-05T21:52:50 (by the time in UA).
