Date of logging it: 2021-02-05T21:57:06 (by the time in UA).
-------
[11001-11100]
посвиряти --- поиграть в свирель
посвене --- особо, в стороне
посвящаю --- освящаю
посвящение --- церковный обряд
посестрие --- супруга, жена
поска --- поцелуй
поскок --- набег, налёт
поскомлити --- завыть, залаять, провизжать
поскору --- скоро, бегло (о чтении)
поскочити --- поскакать
поскепати --- расколоть, расщепить
послание --- послание
посланный --- посланный, 2. домашний, пришедший издалека
послати --- отправлять, послать, отсылать, прогонять
послатися --- ссылаться, приводить в свидетельство
послежде --- после, наконец
пословаться --- послом быть, вести посольское дело
пословица --- согласие, договор, предварительное условие
послух --- свидетель, обличитель, докладчик
послушание --- послушание, иногда - обновление
послушающии --- кающиеся, которые стояли в храме и выходили вместе с оглашенными
послушлив --- послушный, покорный
послyшник --- послушник, служащий в обители ради смирения, прислужник
послушница --- служащая в обители ради смирения, прислужница
послyшничество --- состояние испытания в приготовлении к монашеским подвигам
послушный --- подданный
последисловие --- аннотация о книге, которая раньше размещалась в конце книги
последнее время --- конец века
последняя твоя --- смерть, страшный суд и адское мучение
последок --- напоследок
последородный --- потомок, последующего рода
послежде --- после
посмага --- лепешка
посмаг --- лепешка
посмисатися --- смеяться, шутить, издеваться
посмрадити --- растлить, осквернить любодейством
посмражати --- смрадным делать, осквернять
посмрекати --- выхлебнуть, исчерпать
посмевати --- обращать в смех, издеваться
посмех --- посмешище
посмеятель --- осмеивающий
посмеятельный --- радостный, приятный
посмеятися --- смеяться, насмехаться, 2. радоваться
пособник --- помощник
пособствовати --- содействовать, оказывать помощь, вступаться
пособь --- в разных местах
пособьство --- союз, помощь
посолник --- посланный
посолонь --- таким образом как солнце ходит
посольствовати --- послом быть
посох --- посох, палка, жезл
посочити --- показывать, указывать
посошник --- служитель, держащий архиерейский посох во время служения
посполу --- вместе
поспех --- поспешность, торопливость, 2. способствование
поспешаю --- ускоряю, делаю скоро, успешно, помогаю, содействую, дарую успех
поспешествовати --- пособлять
поспешествуемый --- усердный, живой, сильный, энергичный, успешный
поспешитися --- успешным быть, своевременно исполниться
поспешник --- пособник, помощник
посрамовати --- пристыдить
посрамощение --- посрамление, стыд, бесчестье
посреде --- между, в
поставление --- рукоположение
поставляти --- возвышать, возводить
постав --- ткальный стан, кросна
постать --- стать, сделаться
постельничий --- постельничий, должностное лицо при царе в древней Руси
постижение --- понятие, познание, постижение
постижен --- застигнут
постижно --- постигая умом
постизание --- преследование, погоня
постизаю --- настигаю, догоняю, достигаю, получаю, понимаю, узнаю, познаю, застаю, захватываю
постилаю --- стелю, расстилаю, 2. повергаю, поражаю, погубляю
постихарная грамота --- письменное дозволение овдовевшему диакону от архиерея на служение
постная молитва --- постная молитва
постник --- постник, аскет, прославившийся необыкновенным постничеством
постнический --- постнический, подвижнический, мученический
постничество --- строгое воздержное житие
постничествовати --- поститься, постником быть
постравати --- переворачивать, обращать
пострадание --- действие пострадавшего
пострадатель --- страдалец, мученик
пострань --- возле, подле
пострастити --- таскать, гонять, тревожить
пострашити --- устрашить, навести страх
пострецати --- подстрекать, побуждать
постригальня --- цирюльня
постриг --- пострижение в монашество
пострижение --- обряд принятия в монашество
пострелити --- застрелить, уязвить, ранить
поступаю --- отступаю
пост --- пост
постыдение --- стыд, смущение, душевное волнение
посул --- обещание, взятка
посупление --- потупление взора
посуплен --- смущён, печален, невесел, угрюм
посыпати --- посыпать
посыпный --- насыпанный


-------
Number of things where an exception was: 11019
Date of logging it: 2021-02-05T21:58:44 (by the time in UA).
