Date of logging it: 2021-02-05T21:58:44 (by the time in UA).
-------
[11101-11200]
посытити --- подсластить воду добавлением мёда
поседати --- сидеть, отдыхать сидя
посекатель --- палач, казнитель, кат
посекательный --- служащий для погубления
посетитель --- посетитель, реже - епископ, надзиратель
посещаю --- являюсь, прихожу, навещаю, посещаю, 2. обращаю внимание, испытываю, наблюдаю, 3. вспоминаю, 4. взыскиваю, наказываю, 5. умилостивляюсь
посяг --- брак
посяшти --- трогать, касаться, дотрагиваться
потаемне --- тайно, сокровенно
потаеный --- тайный, сокровенный
потаити --- спрятать, скрывать
потака --- снисходительность, милость, вежливость
потакати --- топтать
потваряти --- превращать
потворник --- льстивый угодник, чародей, колдун
потворный --- волшебный, заколдованный, ядовитый
потворство --- чародейство, колдовство
потирати --- стереть, сгладить, соскоблить
потир --- потир, богослужебная чаша
поткновение --- вбивание, вколачивание, 2. прикосновение
поткнути --- воткнуть, расставить
потник --- войлок, подкладываемый под седло
потоп --- наводнение
потощати --- изрекать, объявлять
потрава --- порча скотиной посевов на полях
потравити --- скармливать, съедать, пожирать, 2. устроить потраву
потратати --- преследовать
потребительница --- разорительница, истребительница
потребитися --- разрушать, истреблять
потребление --- трение, вытирание
потребное --- нужное, необходимое, потребное, должное, 2. справедливое
потребственный --- потребный
потретити --- делать в третий раз
потроп --- заведующий, управляющий, поверенный
потруждатися --- потрудиться, поработать
потружденный --- выработанный, отделанный
потрусити --- посыпать
потрети --- стереть, раздробить, раздавить
потрясти --- потрясти, потрясать
потрястися --- смутиться, в смятение прийти
потусневати --- потускнеть, потемнеть
потчение --- поставление, утверждение
потщание --- беспокойство, заботы, хлопоты, 2. поспешность
потщанно --- усердно, с тщанием, скоро
потщательне --- тщательно, усердно
пот --- пот, 2. усилие, 3. приобретенное большим трудом
потяг --- ремень сапожника
потяжати --- работать, служить, трудиться
потяжитися --- продолжиться, протянуться
потяжба --- принуждение
потязати --- увещевать, журить, 2. позвать в суд
поубожитися --- нищим стать, или притвориться убогим
поуститель --- поощряющий, побуждающий
поустити --- побудить, подстрекнуть, поощрить
поучаваю --- животворю, дарую жизнь, 2. научаю, наставляю в истинах веры
поучаюся --- помышляю, размышляю, 2. забочусь, стараюсь, замышляю, умышляю, 3. возвещаю, изрекаю
поущательный --- поучительный, понудительный
поущати --- поощрять, побуждать, наставлять, поучать
поущение --- возбуждение, поощрение
похабити --- оскорблять, обижать
похаб --- глупый, жестокий, бесстыдный
похарати --- опустошать, разорять
похва --- ножны
похваление --- похвала, одобрение, слава
похвалити --- хвалить, одобрять, поощрять
похвалы --- краткие песнопения
похвальба --- хвастовство
похвально --- превознося себя, с похвальбой
похватити --- ухватить вдруг
похваштати --- схватывать, похищать
похеривати --- уничтожать
похил --- хилый, сухощавый, худощавый
похотник --- желающий недозволенного
похризмити --- помазать миром или елеем
похритатися --- наругаться, насмеяться
похрсть --- крестный ход, торжественное шествие
поцепити --- задеть, прицепить
почакати --- подождать
почати --- приходить, нападать, овладевать
почерпало --- сосуд для черпания воды
почерпсти --- почерпнуть
почествити --- почесть воздать, почтить, уважить
почествую --- почитаю, воздаю почесть, благочествую, вознаграждаю
почестка --- почесть
почесть --- почетная награда, дар, преимущество, отличие, трофей
почиваю --- покоюсь, отдыхаю, успокаиваюсь, освобождаюсь, сплю
почисло --- почесть, честь
почтения --- языческие чествования идолов
почти --- около, приблизительно, едва не
почути --- уразуметь, узнать, постигнуть
пошествие --- выходка
пошлина --- старина, древний обычай, 2. сбор в чью-л. пользу
пощадити --- щадить, жалеть, избегать
пощение --- пощение, пост, говение


-------
Number of things where an exception was: 11107, 11119, 11124, 11157, 11160, 11188
Date of logging it: 2021-02-05T22:00:52 (by the time in UA).
