Date of logging it: 2021-02-05T22:17:18 (by the time in UA).
-------
[11701-11800]
преселяти --- переселять
преселятися --- переселяться
пресквернaвый --- исполненный гнусности, отвращения
преславночудный --- достойный великого удивления, весьма чудный
пресловутый --- известный издавна
преслушание --- непослушание, неповиновение
пресмотрение --- наличный смотр, пересмотр
пресмыкатися --- пресмыкаться, ползать по земле
пресмягнути --- сохнуть
преспеяти --- преуспевать, иметь успех
преставити --- перенести, переставить, переложить, 2. преставиться
преставление --- перестановка, перемещение
преставлятися --- переходить
престание --- прекращение, окончание
престатие --- прекращение, окончание
престати --- перестать
престихийствовати --- преложить стихии, дать стихиям сверхъестественный вид
престихиованный --- стихиями измененный
престол --- престол, трон, седалище, носилки, 2. царство, царствование
престольник --- архиерей, обладающий по сану престолом
престольный праздник --- день памяти события или святого, которому посвящен храм
престрадати --- перестрадать, претерпеть
престрогати --- ранить строганием
преступати --- грешить, ошибаться
преступка --- пропуск в чтении при богослужении
пресущeственный --- существовавший всегда и прежде всего
пресуществление --- пресуществление, перемена вещи на другую, преложение хлеба и вина в тело и кровь Христову
пресуществлятися --- пресуществляться, переменяться, прелагаться в другое
пресущный --- сверхъестественный, необъятный, божественный
преседатися --- лопаться
пресецати --- пресекать, прекращать, останавливать
претензиа --- объявление причины, отговорка, резон
претертие --- перетирание
претесати --- разрубить надвое
претительне --- с угрозой
преткнути --- повредить, запнуть
претолковати --- перевести с одного языка на другой
преторгаю --- расторгаю, прерываю
претороначальник --- главный судия
претор --- судебное место римского начальника, и сам судия
претрудити --- изнурить, утомить
претружденный --- изнуренный, бессильный, дряхлый
претруждшийся --- престарелый
преткнутие --- преткновение, соблазн
претыкати --- запинать, препинать
претя --- скорбя, со смущенным духом
претяжение --- перевес, поход на весах
преудивитися --- изумиться, сильно удивиться
преудобренный --- одаренный высшим благом или совершенством
преудобрити --- достаточно наделить чем-л.
преукрашенно --- с великой славой
преукрепити --- оградить непобедимой крепостью
преумный --- превосходящий ум, понятие
преумудритися --- приобресть, стяжать глубокую мудрость
преусердие --- великая, крайняя ревность
преуспокоити --- доставить совершенный покой
преутучневaемый --- жиреющий, толстеющий
преутучневати --- жирным, толстым делать
префект --- старейшина, начальник
прехапити --- ухватить, схватить
прехождение времени --- последствие времени
пречертити --- вычеркнуть, зачеркнуть
пречинити --- переделать, учредить по-новому
пречистый --- чистый в высочайшей степени
прешествие --- удаление, прошествие, 2. прошедшее
преядати --- поедать, съедать
преяти --- занять чье-л. место, стать преемником
преятие --- передача
прибаска --- пословица
прибеседовати --- собеседовать с кем-л.
приближник --- допускающий к себе близко, позволяющий приближаться к себе, ласковый
прибледый --- бледный
прибожествовати --- набожность иметь, 2. притворяться благочестивым
прибожнок --- пристройка к церкви, придел
прибоище --- небольшой залив, затон
приборствовати --- побороть, переносить с твердостью
прибрадный --- пухом поросший
прибыти --- прибыть, иногда - сообщиться
прибыток --- прибыток, прибыль, доход
прибеглец в церковь --- совершивший неумышленное преступление и прибежавший под защиту церкви
прибегница --- пришедшая в церковь с целью убежища от опасности
прибедити --- сгонять, собирать, 2. принуждать
привада --- приманка, прельщение
приваляюся --- натыкаюсь, набегаю
привати --- казна княжеская
приваты --- уединенные, особенные, отделенные
привведение --- прибавка, прибавление, 2. нововведение
привергатися --- повергаться, стать приверженным, преданным кому-л.
приверг --- припадок
привержен --- поручен, вверен кому-л.
привеслати --- привозить
привзвитити --- приобрести, получить барыш
привздоблевaти --- ратоборствовать
привзыскатися --- вмениться, замениться
привидовати --- воображать, представлять себе
привлещи --- привлечь, позвать, призвать
привмененный --- сравненный с кем-л., почтенный за кого-л.
привменен --- сравнен с кем-л., почтен за кого-л.
привменяти --- уподоблять, сравнивать


-------
Number of things where an exception was: 11789
Date of logging it: 2021-02-05T22:18:44 (by the time in UA).
