Date of logging it: 2021-02-05T22:25:55 (by the time in UA).
-------
[11901-12000]
примикирий --- начальник первой роты, капитан
примикир --- капитан первой роты
примитель --- принимающий, приниматель
примлъва --- приговорка, приговаривание
примозговьница --- затылок
примолити --- желать, нуждаться
примолятися --- молиться, просить
приморие --- приморье, приморские селения
примрак --- сумерки, темноватость, 2. реже - тьма и мрак
примрачение --- потемнение
примрачен --- темновать, пасмурен
примрачитися --- потемнеть, помрачаться, пасмурным стать
примка --- веревка с петлей, петля
примысленный --- придуманный, изобретенный
примыслити --- изобрести, выдумать вновь
примышление --- вымысел, изобретение
примесник --- торгующий с кем-л. совместно
примешаюся --- приближаюсь, сближаюсь
принада --- прибавление
принестися --- дать самого себя в жертву
приниматься --- обращать внимание (на речи)
принос --- приношение, 2. собранное, 3. доход, прибыль, выгода
припадающие --- разряд кающихся
припас --- припас, иногда - выгода, прибыль
приплатитися --- прикрепиться, прижаться
приплескати --- хлопать в ладоши, рукоплескать, аплодировать
приплодити --- принести плод, умножать, увеличивать
приплодовати --- принести
приплодотворити --- дать, принести плоды, 2. усилить действие плодотворения
приплод --- приращение, приумножение
приплоск --- курносый
приплот --- ограждение, вал
припложаю --- собираю плоды
приплешив --- несколько лыс
приповелевати --- изменить повеление
приповедати --- жаловаться, 2. рассказать
приповесть --- рассказ
приподати --- усугубить даяние чего-л.
приполети --- сушить, жарить
припрат --- паперть у храма
припрягаю --- привязываю, прикрепляю
припутие --- место или жилье при дороге
припьрв --- готовый на что-л.
припевка --- припев
припев --- стих, прибавляемый к стихире
припел --- поставленное в древних книгах вместо припева
припетие --- повышение голоса над нужным словом стиха
прирадиво --- усердно, рачительно, тщательно
прирадети --- заботиться, попечительствовать
приратьствовати --- быть союзником на войне
приреку --- говорю
приречь --- прибавить на словах
прирещи --- добавить к сказанному
пририскати --- спешить
приристaти --- прибегать, подбегать
природ --- отрасль, потомок, потомство, род
прироком --- по призванию
прирок --- прозвище, прозвание, 2. оговор, обвинение
приревание --- устремление
прирезонмьц --- ростовщик, 2. капиталист, богач
присадитися --- причислиться, присоединиться
присад --- приплод, приращение, прибыток, отродье
присвидетельствовати --- свидетельствовать
присвоитися --- познакомиться, сдружиться, стать свойственником
присвойтьство --- близость, родство
присвянути --- завянуть, засохнуть
приселитися --- присоединиться, чтобы жить вместе
присельник --- сосед, 2. житель без прав гражданства
присельничий --- принадлежащий чужеземцу
присельщик --- сосед, 2. пришлый, странник, гость
присиловати --- сгонять, принуждать
присияти --- светить
прискакивати --- подступать внезапно, подбегать неожиданно
прискиллиане --- прискиллиане, еретики
присластие --- подслащение
присловие --- заключение или окончание речи в церковных книгах
присмотрение --- похотливый взгляд, любострастный взор
присмотренно --- пристально и с удовольствием
присмядитися --- зачерстветь, загрубеть, потерять свежесть
присно --- всегда, непрестанно, непрерывно
присноблагословeнная --- достойная постоянного благословения, прославления
присноблажeнный --- достойный постоянного прославления
присновоспоминaемый --- всегда величаемый, ублажаемый
приснодвижимый --- всегда находящийся в движении
приснодевственный --- вечно целомудренный
присножелaемый --- желаемый постоянно, вожделенный
присноживопитание --- вечная пища
присноживотие --- вечная жизнь
присноживотный --- составляющий вечную жизнь
присноживый --- всегда живущий, непричастный смерти, вечный
присножительный --- определенный для вечного жительства
присножити --- вечно жить


-------
Number of things where an exception was: 11918, 11929, 11939, 11952, 11967, 11979, 11990, 11998
Date of logging it: 2021-02-05T22:26:38 (by the time in UA).
