Date of logging it: 2021-02-05T22:27:32 (by the time in UA).
-------
[12101-12200]
причастен --- причастен, киноник, стих, поемый во время причащения
причастити --- наследовать
причетати --- причислить, присоединить, присовокупить
причетник --- церковнослужитель, состоящий в церковном клире
причет церковный --- церковнослужители, клир
причет --- причитания
причинитися --- принарядиться, прибраться
причитание --- присоединение, 2. притязание, 3. жалобные стихи по покойникам
причленити --- присоединять
причтатися --- сочетаться, совокупиться
причт рода --- сродники, кроме отца и матери
причясть --- часть, доля
пришествие --- присутствие, собрание, собор
приалчен --- несколько голодный
приединитися --- присоединяться, приобщаться
приемлю --- принимаю, приемлю, объемлю, поддерживаю
приемно --- принимаемо, допускаемо, допустимо
приидущий --- будущий, следующий, грядущий, наступающий
прииждивати --- издерживать, расходовать
приимец --- восприемник, реже - старец
приимник --- принимающий кого-л., 2. восприимчивый
приити --- прийти
приити в мир --- родиться
приобиталище --- место, прибавленное к строению для жительства
приоблистати --- озарить, осиять
приобщаюся --- участвую
приобщеватися --- присоединяться, присовокупляться
приобщник --- сообщник, соучастник, ревнитель
приодеждити --- прикрыть тело одеждой
приодеяние --- одежда
приор --- начальник католического монастыря
приоскудети --- прийти в нищету
приосеняти --- прикрывать тенью, давать тень
приуказ --- пример, образец
приуподобити --- уподобить, сравнить
приусвояти --- присваивать, делать своим
приуязвление --- нанесение раны, изувечивание
Прия --- Прия, богиня любви древних славян
приязнивый --- приверженный, преданный
приязнствовати --- дружелюбным, приверженным быть
приязнь --- дружба, расположение, 2. приятель, друг
приятельство --- дружеское расположение
приятие --- покровительство, заступничество, гостеприимство, признание за истину
приятованный --- принятый, приветствованный
проаст --- предместье, предградие
пробава --- откладывание, отсрочка
прободаю --- прокалываю
пробождение агнца --- действие на проскомидии над агничной просфорой
пробощ --- настоятель монастыря
пробрезгу --- ночью, на рассвете
пробел --- пробел, промежуток
провабити --- манить
провар --- количество напитка, сваренного за один раз
провертети --- провертеть, прокрутить, пробуравливать, просверливать
Провидение --- Промысел Божий
провидети --- пересмотреть, узнать наперед
провидец --- провидец, пророк
провод --- похороны
провождение --- торжественная процессия
провозвествовати --- предвещать, предъявлять
провозвестити --- возвещать будущее, прорекать, предсказывать
провозвещение --- предсказание
провокация --- перенесение дела к высшему суду
провосхищати --- отнимать наперед
проврожити --- предсказывать, ворожить
провещаваю --- прорицаю
провещание --- приветствие
провял --- гнилой, испорченный, 2. высушенный, вяленый
прогалина --- прогалина
проглаголание --- произнесение слова
проглашaю --- подаю голос, провозглашаю
прогневание --- ссора, распря, гнев
прогневати --- раздражить, прогневать
прогневатися --- рассвирепеть
прогоняю --- заточаю в темницу
прогреха --- заблуждение, ошибка, огрех, промах
продажа --- налоги, 2. убыток, ущерб, 3. самовольные поборы, 4. пеня за вину
продaльница --- рынок, базар, торжище
продание --- продажа
продерзание --- дерзость, озорство
продерзатель --- дерзновенный, дерзкий человек
продикиане --- продикиане, еретики
продух --- окно, продушина, 2. родник, ручей, источник
продымленный --- имеющий волосы с проседью
прозарный --- прозрачный
прозелит --- прозелит
прозияватися --- зевать
прознаменовати --- предзнаменовывать
прознательный --- прозорливый
прознательне --- прозорливо, предусмотрительно
прозорливец --- прозорливец, пророк


-------
Number of things where an exception was: 12104, 12105, 12118, 12133, 12162, 12172, 12183, 12188, 12190
Date of logging it: 2021-02-05T22:28:16 (by the time in UA).
