Date of logging it: 2021-02-05T22:34:49 (by the time in UA).
-------
[12301-12400]
проразсуждати --- предварительно обдумывать
проразумник --- предвидящий нужды другого
проразумно --- прозорливо, предусмотрительно
проразумеваю --- предузнаю, предвижу
проразумение --- предвидение Божие
прорасленно --- дав от себя плод
прорасписующий --- описывающий наперед
прорастати --- произрастать, прорастать, пускать ростки, побеги, отпрыски, 2. рождаться, произращать
проречение --- предсказание
прорицатель --- прорицатель, предсказатель, оракул
прорник --- правитель корабля
пророкованный --- прореченный, предсказанный
пророковещательный --- сказанный через пророка
пророкомученик --- пророк, претерпевший мучения за истину
пророкоубийственный --- убивающий пророков
пророкоубийство --- убиение пророков
пророкоубийца --- убивший пророка
пророк --- пророк, предсказатель, прорицатель, предвестник
пророчески --- согласно словам пророка
пророческий --- пророческий
пророчество --- пророчество, предсказание пророка
пророчествовати --- пророчествовать, предсказывать, 2. толковать Св. Писание по просвещению Святого Духа, 3. творить чудеса
пророчица --- пророчица, предсказательница, прорицательница
пророчь --- пророческий
прорствовати --- править кораблем, быть кормчим
проручествовати --- производить в чин священства, рукополагать, посвящать
прорцы --- скажи, угадай, прореки
прорезной оклад --- прорезной оклад
просажаю --- прорываю
просатай --- свят, посредник сватовства
Просветитель --- Просветитель, книга Иосифа Волоколамского
просветительный --- способствующий просвещению
просветлитися --- светлым сделаться
просветованный --- просвещенный
просветение --- блеск, мгновенное явление света
просвещаю --- озаряю, освещаю, 2. учу, вразумляю, просвещаю
просвещник --- просветитель
просиньц --- январь
просительная ектения --- просительная ектенья
просительне --- просительно
просиявати --- начинать сиять
просиятельный --- проникающий насквозь сиянием
проскважнит --- продырявленный, перфорированный
проскинитарий --- поклонник святых мест
Проскомидия --- Проскомидия
проскомисaти --- проскомидию совершать
прославити --- прославлять
прославословити --- праздновать с похвалами
просливый --- докучающий просьбами
прослутися --- прослыть, стать известным
прослутие --- объявление, прославление, 2. народная притча, поговорка, слух, молва
просмонарий --- непрестанный молитвенник
просмрада --- порча, испорченность
просмрадити --- смрадным сделать, осквернить
просо --- просо, пшено
просодия --- термин в грамматике
просок --- разведчик, лазутчик
проспафарь --- главный повар
простати --- начальствовать, быть впереди
простая чадь --- простой народ, чернь
простец --- простолюдин, бедняк, мирянин
прости --- вставши, стоя прямо
простилище --- очистилище, жертвенник
простиралы --- простыня, плащаница
просто --- прямо
простобеседно --- как обычно разговаривают, без разглагольствований
просторек --- говорящий просто, не ораторствуя
просторонство --- простор, покой
простославьн --- чистосердечный, простой, 2. православный
простотствуемый --- любящий простоту
простоумный --- простосердечный, 2. неученый, неграмотный, непросвещенный
пространно --- пространно, 2. роскошно, сластолюбиво
пространноглаголание --- пространное повествование
Прострaнство в скорбех --- так именуют Пр. Богородицу, так как Она способна принять всех скорбящих
прострети --- вытягивать, распростирать
простцы --- миряне
простый --- простой, несложный, 2. неделимый на части, 3. стоящий, 4. искренний, 5. тот, кто прав, 5. простолюдин, 6. не имеющий недостатков
прость --- прямизна, прямой путь
просфора --- просфора
просфорница --- женщина, пекущая просфоры
просфоромисати --- вынимать части из просфоры по церковному чину
прос --- просьба
проссавати --- просачиваться
проседаюся --- трескаюсь, лопаюсь, расседаюсь, разрушаюсь
просед --- седоватый, с сединой
просек --- орудие плотника
просещися --- прорубиться мечами сквозь неприятеля
просядати --- расторгаться, разрываться, трескаться (о винных мехах и каменных зданиях)
протазан --- вид холодного оружия
протат --- верховное управление Афона
протаяние --- источник
Протей --- морской языческий бог
протекдик --- защитник вдов, сирот, беспомощных
протерзатися --- прорываться, продираться
протесати --- рассечь


-------
Number of things where an exception was: 12322, 12356, 12383, 12392, 12399
Date of logging it: 2021-02-05T22:35:28 (by the time in UA).
