Date of logging it: 2021-02-05T22:35:28 (by the time in UA).
-------
[12401-12500]
протестанты --- протестанты, еретики
проти --- до, к (предлог)
противень --- точная копия
противление --- сопротивление, противоборство
противовоздаяние --- воздаяние, возмездие, отплата
противовращатися --- сопротивляться, противостоять, обращаться
противовещати --- прекословить
противоглаголати --- противоречить, прекословить
противогласити --- раздаваться с другой стороны (о звуке)
противограждeнное --- загородка какой-л. вещи
противодостоин --- достойный в сравнении с другими
противозрети --- смотреть прямо
противоити --- идти напротив кого-л.
противоличен --- обращенный лицом прямо к чему-л.
противомудрствовати --- мудрствовать вопреки
противомерный --- соразмерный, соответственный
противообразный --- соответствующий образу
противоополчатися --- вооружаться, восставать
противоополчение --- восстание
противоподвизатися --- подвизаться против кого-л., сопротивляться, противоборствовать
противоополчитися --- противостать
противопрошу --- со своей стороны прошу
противопретися --- спорить, состязаться
противосиятельный --- сияющий прямо
противосияющий --- изливающий подобный свет
противостати --- ставить против, противопоставлять, 2. устанавливать, утверждать
противостяжати --- получить в сравнении с кем-л.
противотворити --- радеть более другого о достижении чего-л.
противуратовати --- сражаться, противоборствовать
против --- против, соответственно, 2. накануне
протиктор --- защитник, покровитель
протицати --- протекать
протлачити --- истаптывать, раздавливать, попирать ногами
протлачьник --- дерзкий, наглец, противник
протоасикрит --- первый секретарь
протодиакон --- протодиакон
протоиерей --- протоиерей
протомагер --- первый повар
протомартир --- первомученик
протонотарии --- прислуживающий константинопольскому патриарху
протопоп --- протопоп, протоиерей
протопресвитер --- протоиерей, протопресвитер
протопсалт --- регент певчих
проторити --- вводить в издержки, обирать
проториться --- нести убытки
проторы --- убытки, издержки, расходы
протосигкрит --- чиновник при константинопольском императоре
протоспафарий --- первый мечник
протостраторь --- начальник стражи
протосимвол --- первый советник у агарян
протосингел --- должностное лицо при патриархе
прототип --- первообраз
прот --- настоятель, игумен
протягаюся --- устремляюсь, подступаю, нападаю
протягнути --- растянуть
протяженный --- напряженный, тщательный, ревностный
протяж --- что-л. протянутое
протязати --- растягивать
протязатися --- распростираться
проуведение --- прозорливость, предусмотрительность
проуведенно --- прозорливо, предусмотрительно
проуведети --- проведать
проуготовати --- готовить заранее, предуготовлять
проумышление --- заранее обдуманная мысль
проуметися --- подумать, посоветоваться
проуразумети --- сверх того еще замечать
проусмотрение --- предвидение
проуставити --- предузаконить, предучредить
проусудити --- предрассудить, предположить
прохлаждaю --- покровительствую, прикрываю
проходень --- бродяга
проходиште --- путь, дорога
проход --- нужное место
прохожду --- прохожу, совершаю
прохырел --- плохой, дешевый
процвести --- процветать, всходить, давать цветы
процена --- цена
проче --- прочь
прошак --- нищий
прошениедавец --- исполнитель прошений
прощение --- прощение
прощенник --- чудесно выздоровевший в святом месте
прощену быти --- прощенным быть, 2. получить исцеление
проесть --- рана
проявленно --- явно, очевидно, 2. по предзнаменованию
проявлятися --- выказываться
професие --- жертвенник
пругло --- сеть, петля
пруг --- кузнечик, саранча
прудный --- каменистый, наполненный камнями
пруд --- пруд, 2. гать, мост
пружаюся --- напрягаюсь, поднимаюсь, 2. терзаю, тормошу, трясу
пружие --- род саранчи
Прусский --- исповедник Павел Прусский


-------
Number of things where an exception was: 12406, 12436, 12454, 12467, 12498, 12499
Date of logging it: 2021-02-05T22:36:09 (by the time in UA).
