Date of logging it: 2021-02-05T22:45:30 (by the time in UA).
-------
[12901-13000]
разумичен --- хитёр, умён, разумен
разумично --- разумно, умно, искусно
разумливый --- разумный, просвещённый
разумник --- исполненный разума
разумно --- понятно
разумший --- разумнейший
разумение --- помысл, образ мыслей, отношение
разуметельный --- узнанный, известный, 2. знакомый, приятель, друг
разумети --- ощутить, почувствовать
разценяти --- судить
разчиняю --- распределяю, привожу в порядок
разябати --- произрастать, пускать ростки
раябсти --- раздробить, сломать, разнести
рай --- рай
рака --- гроб, гробница, урна, ковчег для святых мощей
рака --- плохой человек, низкий, отверженный, презренный, оплёванный
ракл --- одежда
ракно --- одежда
Ралица --- созвездие Большой Медведицы
рало --- соха, плуг
ральный --- служащий для вспахивания
Рама --- Рама, город
рамазан --- месяц поста у мусульман
Рамле --- родина Иосифа благообразного
рамн --- терновник, боярышник
Рамоф --- город, иначе называемый Массифа
рамя --- плечо
рамяный --- великий
ранак --- высечен, жесток, шороховат
ранда --- аренда
ранноядение --- утренний прием пищи как вариант греховной пищевой невоздержанности
рано --- рано утром, 2. к востоку
ран --- ранний
рар --- звон, звук
раса --- ряса
Расин --- Расин, царь
расказити --- разорить, испортить, разломать
раскаяние --- раскаяние, сожаление, жалость
раскврети --- растопить, расплавить
расклаблятися --- насмехаться
раскладати --- раскладывать, раскрывать
расковывати --- перековывать
расковати --- перековывать
раскол --- самовольное уклонение от православной веры
раскольник --- отщепенец от православия
раскоповаю --- разрушаю, разрываю, разламываю
раскоторовaтися --- рассориться, разругаться
раскриляюся --- распространяю объятия
раскръстити --- распять на кресте
раскрепети --- укрепиться
расль --- отрасль, отпрыск, отродье, исчадие, произрастение
расова --- основание, фундамент
расоносец --- послушник
расофор --- ношение монашеской рясы
расоха --- жердь, шест
распаление --- воспаление
распалина --- скважина, трещина, щель
распальне --- горячо, жарко
расписати --- изобразить, описать
распиществити --- назначить питание больному
расплощаюся --- развертываюсь, делаюсь плоским, гладким, 2. распускаюсь (о растениях)
распныйся за ны --- относится к Сыну Божиему, распятому за нас
расположение --- разделение, разлучение, 2. ясное изложение, точный рассказ, 3. растяжение
распопленный --- лишенный священнического сана
распопливати --- лишать священства
распоп --- расстрига, лишенный сана священник
распорити --- раскалывать, разделять
распор --- подъем, рычаг
расправление --- суждение, испытание, истязание
распрати --- распороть
распраштеник --- рассеянный
распростирaю --- излагаю, 2. расстилаю, растягиваю
распрягатися --- разрешаться, освобождаться
распряжение --- разрешение, освобождение, 2. разлучение
распужаю --- пугаю, разгоняю
распустная книга --- отпускная книга, разводное письмо
распустный --- отпускной, разводный
распуст --- распущение, разрешение, разварка
распутие --- широкая улица или перекресток, откуда идут дороги
распущати --- высылать, выпускать, отпускать, 2. ослаблять, 3. посвящать, 4. побуждать, заставлять, 5. распускать, обнажать
распырити --- расширить, раздвинуть
распытьник --- разведчик, лазутчик
распыхаюся --- воспламеняюсь, сильно разгорячаюсь, прихожу в ярость
распьратися --- разлететься
распяло --- крест
распятие --- распятие, казнь
расръд --- прихлебатель, блюдолиз
растаяваюся --- вяну, сохну, чахну
растаяти --- плавить, растапливать, распускать, томить, 2. приводить в изнеможение
растворяти --- растворять, смешивать
растекаюся --- распространяюсь
растесание --- разделение на части
растесанный --- разделенный на части
растес --- разруб, расщелина
расти --- расти, развиваться, 2. возвышаться, 3. становиться сильнее, славнее
растлеваю --- разоряю, разрушаю, соблазняю, ввожу в заблуждение
растление --- повреждение, тление, погибель
растленный --- тленный
растневаю --- колю, раскалываю, терзаю, разрываю на части


-------
Number of things where an exception was: 12967
Date of logging it: 2021-02-05T22:47:11 (by the time in UA).
