Date of logging it: 2021-02-05T22:48:15 (by the time in UA).
-------
[13101-13200]
рещи --- сказать, обещать
ржа --- ржавчина
ржавец --- болото, топь
ржание конско --- языческое празднество по словам пророка Амоса
ржетлеемый --- ржавчиной повреждаемый
ривати --- толкать, тереть, побуждать
рига --- князь, начальник, воевода, 2. овин с сараем для молотьбы, 3. количество обмолоченного хлеба
ризик --- судьба, счастье
ксанфик --- месяц у македонян, соответствующий нашему марту-апрелю
ксилагог --- алое дерево
ксиропотам --- сухой поток, 2. монастырь на Афоне
Ксения --- Ксения
ксенодох --- странноприимец
ксилолой --- алой, алойное дерево
ризит --- какое-то вредное животное
ризница --- место хранения церковной утвари и риз
ризничарь --- хранитель богослужебных одеяний
ризный --- платяной, относящийся к одежде
ризохранитель --- хранитель церковных одеяний
Рим новый --- новый Рим, он же Царьград или Константинополь
ринути --- посылать, бросать, 2. выливать, изливать, 3. распускать, стремиться
Рин --- Рейн, река
Ринофмита --- греческий царь Иустин II, участник шестого Вселенского собора
рипида --- опахало
ристание конское --- конские бега
ристалище --- стадион, арена для спортивных состязаний
ритина --- смола, бальзам
риторика --- риторика, наука о красноречии
риторически --- риторски
риторствование --- красноречие
риторствовати --- упражняться в красноречии, говорить и писать красноречиво
ритор --- красноречивый оратор, ритор
рицка --- речка
рка --- сказал
рку --- говорю
ркомый --- говоримый, произношаемый
робить --- обращать в рабство
роботить --- порабощать
роботствие --- кабала, долговое обязательство, 2. угодье, где живут хлебопашцы
робочищ --- сын рабыни
ровесник --- ровесник, одинаковых лет
ровище --- ров
ровьн --- ровный, верный
рогатка --- старинное орудие, которое надевали на шею преступникам
рогатина --- рогатина, вид копья
рогатьц --- рогатая змея
рогач --- рукоятка сохи
рогоз --- рогоз, тростник
рогозие --- плетеные из прутьев изделия, корзинки
рогопосекаю --- порицаю
рогопосекающий --- бодающий подобно рогам
рогостырь --- мастерская
рог --- сила, крепость, могущество, 2. бугор, холм, возвышенность
рогыль --- дерево, под которым похоронен пророк Исайя
родильнице молитва --- молитва о родильнице
родильница --- женщина, родившая ребёнка (в первые дни после родов)
родительник --- отец, родитель
родительный --- родителю принадлежащий
родительство --- происхождение, порода
родиший --- ближайший
рододелатель --- творец, создатель всего
родоначальник --- прародитель, первый человек
родоначальный --- начало роду дающий
родословен --- относящийся к родословию предков
родословие --- исчисление своих предков с похвальбой
родословные люди --- сословие людей древней Руси, поколенные росписи которых были записаны в книгах
родостама --- розовая вода, употребляемая при освящении антиминсов и престолов
родофор --- место, где много роз
родьство --- ад
родьнина --- родная сестра
рожа --- роза
рожаницы --- древне-славянские божества
рожаник --- рог, лук
рождак --- родственник
рожданица --- день рождения, по которому суеверные примечают будущее счастье
рожденик --- книга, указывающая добрые и злые дни и часы и их влияние на родившихся младенцев
рождественне --- по рождению, по причине происхождения и пр.
Рождество Христово --- церковный праздник Рождество Христово
рождие --- ветвь, отрасль
рожен --- железный рог, остроконечное орудие
рожи --- маски
хари --- маски
личины --- маски
рожок --- пастуший музыкальный инструмент из рога животного
рожоперстый --- обладающий розовыми пальцами
розпашь --- обработанная земля
розрядные книги --- книги с указанием родословных
розряд --- учреждение, ведущее розрядные книги
розруб --- подать, дань
розстань --- перекресток
розстрадный --- обработанный, возделанный
розыск --- рассматривание, исследование, 2. книга о брынских раскольниках
розыщик --- допрашивающий, истязающий, ведущий следствие
рококо --- архитектурный стиль
рокотати --- издавать звук, подобный рокоту воды
роксолань --- древний народ южной России
рок --- год, мера, определенное число


-------
Number of things where an exception was: 13118, 13146, 13191
Date of logging it: 2021-02-05T22:48:56 (by the time in UA).
