Date of logging it: 2021-02-05T23:12:52 (by the time in UA).
-------
[13501-13600]
сарацины --- сарацины, аравийские племена
Сараффия --- сарептская вдова
сардион --- сердолик
сардий --- сердолик
сардоникс --- драгоценный камень из Сардинии
Сарей --- один из предков Ездры
Сарепта --- Сарепта, город
Саркел --- Саркел, столица хазар
саркофаги --- гробы из камня, металла
Сарматия --- древняя страна между Доном и Дунаем
Сарон --- Сарон, плодородная долина, которую иногда отвоевывали филистимляне
саран комат --- разновидность епанчи
сасыч --- горн, горнило, 2. горшок
сата --- мера сыпучих тел
Сатана --- Сатана
сатанинский --- сатанинский, дьявольский
сатир --- сатир, леший
сатрап --- персидский областной управитель
сатурналии --- языческий праздник в честь Сатурна
Саул --- Саул, первый царь израильский
сахон --- разумный
сачьц --- какая-то одежда
саян --- вид женской одежды
сбиралище --- ров для сбора дождевой воды
сбогословити --- богословствовать согласно с другими
сбодати --- заколоть
сбои --- всякий сброд
збои --- всякий сброд
сборная палата --- панихидная палата в верхней части дворца
Сборное воскресенье --- первое воскресенье великого поста
сборы --- соборы
сбости --- изранить во многих местах
свада --- смута, ссора
свадити --- ссорить, поссорить
свайка --- древнерусская игра
свара --- ссора, брань
сварити --- бранить
сваритися --- ругать, поносить, бранить, злословить
Сварог --- Сварог, славянское божество
сваряю --- растопляю, потребляю
сваряюся --- ссорю
сваха --- сваха, 2. сестра жены
свеи --- шведы
свепетати --- трепетать
свепет --- дикий лесной мед
сверб --- зуд, чесотка
свердло --- сверлило, бурав
сверстаться --- поровняться
сверстник --- супруг, муж
сверстный --- сверстник, ровесник, 2. равный возрастом, чином или званием
сверхдолжныя --- заслуги сверх необходимого, признаваемые католической церковью для освобождения от чистилища
сверепица --- журавлиный горох
сверепомаслина --- дикая маслина
сверепство --- свирепость, беснование, ярость
сверепый --- свирепый, дикий, лютый
сверепею --- свирепствую
свеселюся --- веселюсь с кем-л.
свестьн --- сроден, сообразен
свечеряти --- вечерять, ужинать вместе с кем-л.
свиблив --- шепеляв, косноязычен
свибьн --- июнь
свидетельный --- свидетельствующий или способный свидетельствовать
свидетельство --- свидетельство, отзыв, 2. мученичество
свидетельствуюся --- употребляю, пользуюсь
ю --- её
юба --- ремень, повод, вожжи, 2. бразды правления
юбилей --- трубный звук, посредством которых объявлялся юбилейный год
юбилейный год --- отмечался у евреев раз в 50 лет
Юдифь --- Юдифь
юдо --- морское чудовище
юдолие --- низменное место, низина, долина, равнина, соляная долина
юдольный --- находящийся в долине
юду --- где (не в вопросе)
юдей --- иудей
юже --- которую
южика --- родственница
южский --- южный
южный --- южный
юза --- узы
юзилище --- тюрьма, темница
юзник --- узник, колодник
Юлиан --- Юлиан
юма --- лодка, судно
юмшан --- броня из дощечек, соединенных кольцами
юностный --- юный, молодой, юношеский
юность --- юность, молодость, юношество, 2. новость, 3. роскошь, изнеженность
юнота --- юноша, отрок, 2. девица, отроковица
юнотный --- бодрый
юнотство --- юность, молодость
юнотствую --- поступаю неосмотрительно, подобно молодежи, 2. бодрствую, мужаюсь
юноша --- юноша
юношески --- юношески, с юношеской бодростью, мужественно
юнчий --- телячий
юн --- юный
юнети --- юным казаться, 2. в юности находиться
Юрг --- Георгий, Юрий


-------
Number of things where an exception was: 13574, 13586, 13595, 13599
Date of logging it: 2021-02-05T23:16:34 (by the time in UA).
