Date of logging it: 2021-02-05T23:16:34 (by the time in UA).
-------
[13601-13700]
юродивый --- юродивый, глупый, 2. особый чин святых
юродословие --- глупые, сумасбродные речи
юродственный --- юродивым свойственный, безумствующий
юродство --- юродство, глупость, безумие
юродствую --- дурачусь, представляюсь глупым, безумным, юродивым
юродею --- глупею, безумею
юродюся --- юродствую, дурачусь, представляюсь глупым
юрта --- круглый шатер восточных народов
юр --- открытое место
юрьев день --- день перехода крестьян от одного помещика к другому
ютро --- утро
Ютта --- Ютта, город в Иудее
юфть хлеба --- хлебная мера XVII века
юха --- уха, бульон из мяса или рыбы, юшка
юхть --- разновидность выделанной кожи
свила --- место у дерева, где волокна переплетаются
свинопaственный --- относящийся к пастьбе свиней
свинья --- свинья, 2. особое построение войска
свираль --- свирель
свирец --- играющий на свирели
свирели --- духовые инструменты
свирепие --- свирепство, лютость, ожесточение
свирепоустие --- дерзновенные речи
свирепею --- свирепствую, 2. остаюсь в запущении, дичаю
свиряю --- играю на свирели
свисети --- висеть вместе
свита --- фелонь, риза, 2. лица, сопровождающие знатных особ
свитаю --- светаю
свитль --- опоясание, одежда
свиток книжный --- древняя книга в виде свитка
свиток нов --- доска, ещё не исписанная
свиточный --- власяничный
свобода --- слобода
свободительный --- предоставляющий право пользоваться свободой
свободити --- освободить, сделать свободным
свободник --- отпущенник, пущенный на волю раб
свободный --- непреклонный, непоработимый
свободь --- свободный, вольный, предоставленный сам себе, 2. беспомощный, брошенный
свобождаю --- освобождаю, искупаю, выкупаю
свобьство --- личность
свод --- ковчежец, дарохранительница, 2. отыскание виновника правонарушения
своемненно --- по своему суждению, своенравию
своеплеменный --- одного племени или рода
свожду --- ниспускаю
свозопияти --- вопиять вместе с кем-л.
своинство --- товарищество по военной службе
своинствовати --- воинствовать вместе с кем-л.
свойски --- по-своему
свойственно --- собственно, по свойствам
свойственный --- собственный, домашний, кому-л. исключительно принадлежащий, родственный, свойственный
своищина --- своё
свора --- веревка
сворохнуться --- пошевелиться
своспитатися --- свыкнуться, быть воспитанным вместе с кем-л.
свосприимати --- принимать вместе с кем-л., соучаствовать в принятии или получении
свояк --- тот, жена которого приходиться сестрой жены другого
свояси --- своё место
своячина --- сестра жены
свраб --- шероховатость, 2. шелудивость, чесотка, 3. сильное желание
сврак --- чешущийся, страдающий от зуда
сврч --- сверчок
свршть --- кузнечик, стрекоза
свыпрь --- сверху, свыше
свычай --- привычка, всегдашнее знакомство
сведом --- известный, 2. сведущий, опытный, знающий
сведочество --- свидетельство
сведущий --- сведущий, искусный, знающий
сведетель --- сведущий
свеже --- ново
свеи --- шведы
свем --- ведаю, знаю
свенитися --- храниться, удерживаться
свен --- без, кроме
свеньство --- отсутствие
сверепогубитель --- жестокий мучитель, убийца, лютый истязатель
свестити --- объявить, возвестить, сказать всем
свесть --- золовка, сестра мужа
светаю --- встаю на рассвете, встречаю рассвет
светилен --- стих, читаемый на утрене после канона
светильник --- светильник, подсвечник, канделябр, лампада
светильничный --- относящийся к светильнику
светильничныя молитвы --- молитвы, читаемые священником про себя на вечерне
светильный --- служащий для освещения, возжигаемый
светильство --- блеск, слава
светильце --- лампадка
светлая лаконская --- блестящие одежды
светлица --- самая большая комната в доме
светло --- великолепно, пышно
светлогласный --- ясно возвещающий, гласящий
светлодневный --- днём сияющий
светлое платье --- одежда чиновников при царском дворе
светлозрачный --- светлое лицо имеющий, сияющий вид
светлоносец --- носящий в себе свет
светлоносивый --- облеченный в светлые ризы


-------
Number of things where an exception was: 13602, 13617, 13619, 13639, 13650, 13661
Date of logging it: 2021-02-05T23:19:09 (by the time in UA).
