Date of logging it: 2021-02-05T23:19:09 (by the time in UA).
-------
[13701-13800]
светлоносити --- носить светлую одежду
светлоношение --- чистое праздничное одеяние, наряд
светлоношу --- ношу светлую одежду, 2. торжествую, веселюсь, красуюсь
светлообрaзный --- являющийся в светлом образе
светлоодеятися --- надеть светлую одежду
светлоплодовитый --- приносящий прекрасные плоды
светлоподобник --- сияющий как свет чистотой добродетелей
светлопозлащен --- украшен великолепно
светлосиянный --- блистательный, подобно солнечному свету
светлостный --- исполненный сияния
светлотекущий --- текущий светло, благополучно, радостно
светлетися --- делаться чистым, непорочным
светлю --- просветляю
светник --- советник
световержение --- отблеск, проблеск, игра света
световидно --- подобно свету
световидный --- подобный свету
Световид --- славянский бог
световодец --- светильник, указывающий путь во тьме
световодитель --- ведущий во свете, ясно, верно
световожду --- свечу, указываю путь, веду, просвещаю
светодавец --- светоносец, податель света, просветитель
светодательный --- освещающий
светодаяние --- освещение
светодержец --- владыка света
светодетель --- творец света
светозарение --- блеск, сияние
светозарно --- блистательно
светозарность --- сияние, блистание
светозарный --- светлый, блистательный, цветущий
светозаряю --- озаряю светом
светоименный --- светлый, блистательный, славный, имеющий имя от света или светильника
светолитие --- яркий свет, сильное блистание
светоличный --- подобный свету
светолияние --- излияние света
светолучивый --- лучезарный
Светом Господним --- учение Божие вообще
светонаставление --- указание света, 2. наставление, как ходить во свете
светонаставник --- руководитель к свету, просветитель
светоначaльник --- виновник, источник света
светоначальный --- первосветлый, первообразно испускающий свет
Светоносец --- Светоносец, Денница, Люцифер, Сатана, 2. некоторые святые
светоносити --- изливать свет
светоносица --- носящая свет, светозарная
светоносие --- излияние света
светообразный --- световидный
светоприемница --- принявшая или вместившая в себя свет
светоприемный --- светоносный
светородительница --- матерь света
светородный --- производящий свет
светосияние --- сияние света
светосиянно --- сияя светом
светослов --- вещающий о божественном свете
светотворец --- создатель света
светоявление --- место, озаренное светом
светоявленно --- радостно, торжественно, громко
светоявленный --- ознаменованный светом, явившийся светлым
свет --- свет, 2. евангельское учение, 3. Сын Божий, 4. проповедник Евангелия, 5. всё светлое
светыч --- фонарь
светение --- свет, освещение
свеча --- свеча, светильник, факел
свещательный --- просветительный, просвещающий
свещевжигатель --- церковнослужитель, зажигающий свечи перед иконами
свещеимею --- держу свечу, иду со светильником
свещение --- освещение
свещеносица --- предшествующая кому-л. со свечой
свещеносный --- держащий в руках свечу
свещеношу --- несу свечу, иду со светильником
свеществетити --- светить, неся свечу перед кем-л.
свещу --- свечу, озаряю
свещуся --- свечусь, блистаю
связень --- узник, колодник
связлце --- связочка, маленький пучок
связывати --- соединять, 2. не прощать, препятствовать
связь --- связание, 2. запрещение, извержение, проклятие
Святая гора --- Афон
святая святых --- помещение в скинии и Иерусалимском храме, где хранился Ковчег Завета
святец --- святой, праведный человек, 2. лицемер, святоша, ханжа
святилище --- священное место богослужения, скиния, храм, 2. помещение в скинии или Иерусалимском храме, смежное со святая святых
святило --- святилище
святки --- праздничные дни от Рождества Христова до Крещения Господня
святоблаженный --- чествуемый за святость
святовещанный --- изреченный по вдохновению Святого Духа
святогорец --- житель горы Афон
святоградец --- уроженец, житель Иерусалима
святоделанный --- свято созданный, на святое употребленный
святожительный --- ведущий святую жизнь
святозрачный --- имеющий святой вид
святокрадьство --- святотатство
святоненавистник --- ненавистник святых и всего священного
святоненавистница --- ненавистница святых и всего священного
святопервый --- первый из святых
святопомaзанный --- освященный помазанием
святопочитaемый --- ублажаемый ради святости
святопочити --- умереть блаженной кончиной
святопевьц --- поющий в храме


-------
Number of things where an exception was: 13701, 13711, 13721, 13765
Date of logging it: 2021-02-05T23:21:33 (by the time in UA).
