Date of logging it: 2021-02-05T23:21:33 (by the time in UA).
-------
[13801-13900]
святотaтство --- кража святого
святотaтец --- похититель священных вещей
святохульник --- презритель, хулитель святыни
святоша --- притворяющийся святым, лицемер, ханжа, 2. святой, свято живущий
святцы --- перечисление святых и праздников по порядку месяцеслова
Свят --- святой
святый --- святой
Святый Израиля --- Иисус Христос
Святый святых --- Иисус Христос в смысле превосходной степени святости
святыня --- части жертвенных животных и хлебы предложения
святые врата --- царские врата храма
святьба --- освящение
святейшество --- титул патриархов в древней Руси
святяй --- освящающий
свящательный --- освящающий, служащий для освящения
священие преявственное --- светлое святилище
священник --- священник, иерей, батюшка
священноблажeнный --- ублажаемый церковью
священнограбитель --- святотатец
священнограбительство --- святотатство
священнодейственник --- совершитель священного служения
священнодейственный --- относящийся к священнодействиям
священнодействие --- служение божественной литургии, реже - других служб
священнодействовати --- совершать литургию, таинства, др. службы, совершать всякое священное действие
Священное писание --- Священное писание, Библия
священноинок --- иеромонах
священноисповедник --- священнослужитель, пострадавший за исповедание веры
священнолепно --- священно, достойно святыни
священнолепный --- соответствующий святости
священномученик --- мученики, имевшие священный сан
священнонаучатися --- познавать священные догматы
священноначалие --- церковное начальство
священноначaльник --- архиерей
священноначaльствуемый --- подчиненный архиерею
священнообрaзный --- представляющий священное изображение
священноодеяние --- священнослужительское одеяние
священнописание --- священное изображение
священнопобедный --- одержавший победу в священном подвиге
священноповествовaти --- рассказывать о священном
священнопомaзание --- помазание святым елеем, духовное помазание, сообщение даров благодати
священнопредстоятель --- первенствующий священник
священнопроповедати --- проповедовать о священном
священнопроповедник --- проповедник священных истин
священнородный --- рожденный от священнослужителя
священнословие --- священная речь
священнословлю --- говорю о священном
священнословный --- проповедующий слово Божие
священнослов --- проповедник слова Божиего, также учитель, толкователь
священнослужитель --- церковнослужитель, обладающий степенью священства
священносподвижный --- подвизающийся в священном деле вместе с кем-л.
священнострадaлец --- пострадавший за веру, имеющий степень священства
священнотаинник --- получивший откровение священных тайн
священнотaйный --- относящийся к священным тайнам
священнотaйне --- священнотайным образом
священнотaтство --- святотатство
священноученик --- священный ученик, обучающийся святой вере
священнохранитель --- служащий вместилищем чего-л. священного
священноявитель --- провозвестник, священный учитель
священноявлeнный --- провозвестник святых тайн, тайновидец, тайноучитель
священный --- освященный, посвященный
священный недуг --- лютая проказа
священный певец --- царь Давид
свящeнство --- таинство рукоположения, священство
сгребие --- сор, грязь
сгромаждение --- собрание
сдивоваться --- удивляться
сдравьлю --- здравствую, являюсь здоровым
сдробляю --- раздробляю, разламываю на мелкие части
себо --- ибо, ибо вот
себрь --- простолюдин
Севама --- город моавитян
Севастия --- древняя Самария, а также область в Армении
Севаст --- Август (государь)
сега --- теперь
сегасветьн --- сего мира
сегда --- вероятно
сегов --- сего
Седекия --- Седекия, последний иудейский царь
седмерица --- число, состоящее из семи
седмижды --- семь раз, семикратно
седмина --- седьмое по порядку
седмичисленники --- семь учеников Кирилла и Мефодия
седмобратеньц --- один из семи братьев
седморижди --- семь раз
седморити --- усемерять
седморица --- неделя
седмосветильный --- семь светильников имеющий
седмоусугубити --- умножить в семь раз
седмь --- семь
Седрах --- имя св. Анании при дворе Навуходоносора
сежде --- тоже
сеземьц --- туземец, коренной житель страны
сей --- этот, тот, сей
Сейр --- гора в Идумее и сама Идумея
Сиир --- Исав
сеит --- учитель магометанского закона
сейци --- сейчас
секрат --- ныне


-------
Number of things where an exception was: 13822, 13889
Date of logging it: 2021-02-05T23:23:50 (by the time in UA).
