Date of logging it: 2021-02-05T23:26:07 (by the time in UA).
-------
[14001-14100]
синагога --- синагога, еврейская молельня, церковное собрание иудеев
синаит --- житель Синая
Синай --- Синай, гора
синаксарий --- собрание сведений о празднике или о святом
синапти --- великая или малая ектенья
синап --- горчица
синдик --- ходатай, адвокат, стряпчий
Синдонит --- пр. Серапион Синдонит
синдон --- плащаница или полотно
синегръвен --- синеватый, красновато-синий
синедрион --- высшее судилище у древних евреев
синета --- гиацинт
синетный --- окрашенный синей краской
синец --- вид бесов
синкелл --- пресвитер или монах, живущий при патриархе, как сотрудник и свидетель непорочной жизни
синклитик --- чин государственного совета
синклитство --- верховное достоинство, знать
синклит --- верховное гражданское правительство, собрание
синодaльно --- соборно, собором
синодик --- книга со списком поминовения усопших
синод --- синод, постоянный собор пастырей для управления делами церкви
синопсис --- сокращение, выписка, краткое обозрение
Синоптическия евангелия --- Синоптическия евангелия - первые три евангелия, т.е. от Матфея, Марка и Луки
синор --- граница, сопредельность, смежность
синтаксис --- часть грамматики о законах сочетания слов и предложений
син --- стан евреев перед горой Синай
синяя проказа --- род болезни, свойственной жарким странам
сионов --- сионский
сипль --- долгоносик
сирин --- сирена, морское чудовище, 2. мифическая птица
Сирия --- Сирия, Арамея
сиромах --- бедняк, бедный
сиропитатель --- кормилец сирот
сиротен --- сирота, сирый
Сирофиникия --- область Сирии по берегу Средиземного моря
сирски --- по-сирийски
сир --- сирый, убогий
сиречь --- то есть
сита --- сеяние, 2. мера в полтора четверика
ситовный --- относящийся к траве ситнику
ситтиим --- разновидность акации, из которой был построен ковчег завета
ситуация --- местоположение
Сихарь --- город на северо-востоке Сихема
Сихем --- Сихем, город
сице --- так, таким образом
сицевый --- другой, совершенно такой
сиц --- такой
сица --- это
Сиф --- Сиф, сын Адама
сионская горница --- группа зданий в Иерусалиме. Там была тайная вечеря, схождение Св. Духа на апостолов и апостольский собор
Сион --- Сион, гора возле Иерусалима
сирини --- страусы
сиятельное --- свойство источника света
скажение --- порча, повреждение
скакавица --- кузнечик, кобыла, стекоза
скакуны --- сектанты-хлысты
скалвы --- весовые чашки весов, или весы
скалы --- весовые чашки весов, весы, 2. пороги, ступени
скандалисати --- соблазнять
скандал --- соблазн
скандел --- соблазн
сканый --- сотканный, сквозной
скарб --- пожитки, имущество, скарб, 2. сокровище
скаредие --- гнусность, мерзость
скаредовати --- мерзить, представлять скаредным
скважня --- сквозное отверстие
сквара --- нечистота, мерзость, 2. зной, жар
скверна --- нечистота, гнусность, разврат, распутство
сквернавый --- доступный, нечистый
сквернение --- беззаконная, непотребная жизнь
сквернено --- скверно, непотребно
скверник --- непотребствующий человек
сквернити --- почитать что-л. скверным, нечистым
сквернитися --- растлеваться
сквернобрачие --- сожительство вне брака
скверновелеядец --- склонный к обжорству
скверногласие --- непотребные песни, срамные слова
сквернодей --- распутный человек
сквернословие --- скверные, омерзительные речи
сквернострастие --- сластолюбие
скверностяжaтель --- применяющий скверные средства для своего обогащения
скверноубийственный --- посягнувший на беззаконное убийство
скверноубийство --- беззаконное убийство
скверноубийца --- гнусный убийца
сквернства --- разные виды сквернодействия
скверчити --- стиснуть, скрутить
сквозе --- сквозь, через
скврада --- очаг, дом, имущество
скврнити --- осквернять
скевофилакс --- сосудохранитель, ризничий при царе или патриархе
скепище --- древко копья, рогатины или др. оружия
скептики --- философы, во всем сомневавшиеся
скербь --- скорбь
скимен --- львёнок, 2. молодой сильный лев
скиния Давидова --- династия Давида, царствовавшая в Иерусалиме
скинопигиа --- праздник кущей
скинотворец --- делающий палатки
скипа --- хлебный червь
скипетр --- скипетр


-------
Number of things where an exception was: 14018
Date of logging it: 2021-02-05T23:28:52 (by the time in UA).
