Date of logging it: 2021-02-05T23:28:52 (by the time in UA).
-------
[14101-14200]
скитник --- житель скита, отшельник, пустынник
скитовцы --- скитальцы
скитский --- отшельнический
скит --- скит, малый монастырь, уединенная монашеская обитель
скитянин --- скитник, отшельник, пустынник
Скифия --- древняя страна, населяемая скифами
склабитися --- улыбаться, усмехаться
складни --- складные металлические выпуклые образа
склевретствовати --- сотовариществовать, сопутствовать
склеп --- склеп, гробница
сключение --- смычка, балка, накат
скляница --- стеклянный или хрустальный сосуд, склянка
склязь --- монета
склячити --- скорчить
скнипы --- вши
скоба --- нота для чтения
скобел --- скобель
сковник --- участник в заговоре, сообщник, соумышленник, сомятежник
сковрада --- сковорода, кастрюля, противень
сковраньць --- жаворонок
скоглати --- выть, скучать
скоком --- во всю прыть
скоктание --- щекотание, чувственные ласки
скокчу --- приятно раздражаю, ласкаю
скок --- скакун
сколка --- устрица, раковина
скомление --- ворочание языком
скомлю --- ворочаю языком
скоморошество --- скоморошество, фиглярство, фокусничество, забавы
скомрах --- скоморох, шут, плясун
скончаваю --- оканчиваю, совершаю
скончавшийся --- умерший, скончавшийся, покойный
скончаный --- необрезанный
скопение --- состояние скопчества
скопец --- скопец, кастрат, евнух
скопечество --- неспособность к продолжению рода
скопити --- выхолостить, кастрировать, исказить, лишить мужской природы
скопление --- оскопление, кастрация
скопчий --- свойственный скопцу, евнуху
скора --- кора
скорбение --- болезнование
скорлупа --- зерно виноградной ягоды
скоровьн --- скорый, поспешный
скоровек --- краткий
скорогиблющий --- скоро погибающий, скоро разрушающийся
скоромно --- недозволенная в пост пища
скоропарный --- способный быстро летать
скорописец --- исправный писарь
скоропослушный --- всегда готовый к послушанию
скороприводен --- тот, которого нетрудно преклонить к чему-л.
скоропреложьн --- переменчивый
скоропытание --- несвоевременное излишнее любопытство
скоропытный --- осторожный, предусмотрительный, благоразумный
скоротечец --- скороход
скоротещи --- течь стремительно, бежать
скоротлимый --- скоротечный, быстро разрушающийся
скороходец --- посыльный
скороходы --- телохранители царя в путешествиях
скорошественный --- быстро несущийся
скороядьц --- ненасытный
скорпиин --- принадлежащий скорпиону
скорпионы --- скорпионы
скорпия --- скорпион
скотий --- скотский
скотник --- заимодавец
скотница --- казна
скотный --- подобный скоту
скотоложник --- зоофил, скотоложник
скотоложство --- зоофилия, скотоложство
скотопажитный --- изобилующий пажитью
скотопитатель --- скотовод
скотопитательный --- дающий обильную пищу скотине
скотопленение --- угон скота
скотоподобие --- уподобление скоту по гнусным и срамным делам
скототлитель --- скотоложник, зоофил
скотски --- безрассудно, несправедливо, скотски
скочение --- прыжок
скра --- глыба, слиток
скрай --- край, подол
скраний --- висок
скрегтати --- скрежетать, скрипеть зубами
скрежет --- скрежетание
скрилятися --- крыльями соединяться
скринив --- переменчив
скриница --- ковчежец, сундучок
скроб --- чесотка
скровник --- единокровный брат
скров --- скрытое, потаенное место, 2. хранилище, 3. хранение
скрбь --- скорбь
скрываю --- скрываю, подавляю
скрыни --- ларчики, сундучки
скубиторский --- спящий с кем-л. в одной постели
скудел --- черепица
скудeльница --- глиняный кувшин, 2. убогий воспитательный дом
скудельничий --- горшечнику принадлежащий
скудный --- лишённый, неимущий, нуждающийся
скудобрадый --- обладающий редкой, маленькой бородкой
скудота --- нищета, убожество
скудство --- недостаток, убожество, нищенство, скудость
скудствовати --- нищенствовать


-------
Number of things where an exception was: 
Date of logging it: 2021-02-05T23:31:36 (by the time in UA).
