Date of logging it: 2021-02-05T23:33:54 (by the time in UA).
-------
[14301-14400]
служебница --- церковная служительница, диаконисса
служебне --- богослужебно, с благоговением
служение --- истукан, идол, 2. религиозный обман, ложные чудеса, 3. услужение, прислуживание, 4. богослужение
служитель --- диакон, священнослужитель, угодник, поклонник
служка --- служитель при монастыре или храме
служу --- нахожусь в рабстве
слукaвствовати --- страдать, терпеть, находиться в худом положении, 2. поступать плохо
слукий --- сгорбленный
слуковaти --- лукавить вместе с кем-л.
слухи --- слуховые окна
слушаю --- умилостивляюсь, соглашаюсь, уступаю
Слънце --- солнце, светило
слъпати --- прыгать, скакать
слышаный --- слышимый
слышу --- слушаю
слебное --- посольское
следив --- чуткий, с особым чутьем (о собаке)
следний --- крайний
следованный --- расположенный в определенном порядке
следогонити --- подражать, идти по следам, последовать
следотворити --- пролагать следы, показывать дорогу, шествовать
слезена --- селезенка
слема --- верх крыши
сленати --- прыгать, скакать
слепотный --- слепой
слепый --- слепой
слепоумный --- человек с непросвещенным умом
слепе --- слепы в двойственном числе
слюблено --- полюбовно, по доброй воле
сляка --- сгорбленная, скорченная
слякий --- согнутый, скорченный
сляцание --- согнутие
сляцаю --- сгибаю
сма --- смола
смага --- жар, пламя, огонь
смагльный --- темный, смуглый
смазание --- склейка, сплочение, соединение
смазни --- суррогат драгоценных камней
смарaгдовый --- изумрудный
смарaгд --- изумруд
сматряю --- подсматриваю
смердaлеон --- страшное видение
смерд --- смерд, человек низкого происхождения
смердети --- смердеть, зловонно пахнуть
смердящий --- зловонный
смерзлый --- смерзшийся
смертоносие --- зараза, тлетворный воздух
смертоточный --- смертоносный
смерть --- смерть
смерчи --- можжевельник или иной хвойный кустарник, по другим данным - олива
смерчий --- можжевеловый, масличный
сметище --- место для мусора
сметие --- сор, мусор, грязь, отруби, высевки, паутина, навоз
сметная --- пошлина, вносимая в случае оправдания
смидaльный --- приготовленный из самой тонкой пшеничной муки
смилакс --- шип
смило --- приданое
смилное --- брачная пошлина
смиренномудрие --- смирение
смиренномудровати --- смиренным, кротким, вежливым, учтивым быть
смиренномудрый --- смиренный духом, кроткий
Смирна --- город в Лидии, 2. благовонная смола
смирник --- усмиритель, миротворец
смирное платье --- траурное одеяние
смиряю --- укрощаю, низлагаю, истощаю
смлачитися --- раздробленным, сокрушенным быть
смо --- есмы
смоквичие --- смоковница, сад смоковниц
смоквы пeрвых времeн --- первый в году урожай смокв
смоковница --- смоковница, дерево инжир
смок --- змий, дракон
смола --- смола, асфальт, нефть
смолва --- сговор, соглашение
смолeбник --- молящийся или ходатайствующий вместе с другими
сморч --- смерч
смерч --- смерч
смотрительно --- по распоряжению Божиему
смотреливо --- рассудительно, с намерением
смотреливый --- прозорливый, проницательный, провидящий
смотрь --- соглядатай
смрк --- труба, канал
смръцати --- выпивать, поглощать
смреча --- кедр
смугленый --- смуглый, темноватый, смурый
смудреник --- имеющий одно мнение с кем-л.
смудрствовати --- рассуждать одинаково с кем-л.
смученик --- претерпевший мучения вместе с кем-л.
смучити --- пресмыкаться
смысленник --- единомышленник, соучастник
смысленно --- разумно, со смыслом
смыслодaвец --- податель смысла, разума
смышление --- стечение, соединение, 2. понятливость, рассудок, знание, 3. совесть, сознание
смычник --- применяющий смычок для игры на музыкальном инструменте
смед --- смуглый, темноватый
смежаю --- смыкаю, зажмуриваю (о глазах)


-------
Number of things where an exception was: 14332, 14362, 14377, 14382, 14400
Date of logging it: 2021-02-05T23:36:11 (by the time in UA).
