Date of logging it: 2021-02-05T23:45:23 (by the time in UA).
-------
[14801-14900]
сочетавaтися Христу --- вступать в завет или духовный союз с Христом
сочиняю --- совокупляю, устанавливаю, определяю, помещаю, даю приют
сочислити --- исчислить
сочислитися --- сопричислиться
сочить --- отыскивать, требовать, подавать иск
сочлинити --- совокуплять, соединять
сочлинитися --- совокупляться, присоединяться
сочтаватися --- вступать в союз, соединяться
сочетание --- плотское совокупление
сочьба --- донос, клевета
сошeственник --- сотоварищ в пути
сошествие --- сошествие, схождение
сошeствовати --- идти совокупно
сошное письмо --- подати, взимаемые с владельцев земли
спальники --- должностные лица древней Руси, спавшие по очереди перед спальней государя
спасение --- спасение, защита
спасеный --- спасительный
спасися --- пожелание в церковных книгах вместо \"Прощай\"
Спаситель --- Спас, избавитель от бед и несчастий
спасительная --- благодарственные жертвы
спасительные явления --- отвержение Господом жертв и праздников, служивших, по мнению израильтян, спасительным средством
Спасов пост --- Успенский пост
спастися --- спастись, устремляться
Спас --- избавитель от бед и несчастий
спата --- меч, шпага
спекулатор --- страж, палач, царский телохранитель
спень --- металлическая проволока для ожерелий
спеньза --- издержки, расход
спинаю --- низлагаю, низвергаю
спира --- известное число людей, по воинскому - рота или полк
спиратися --- спорить
спирида --- корзина с припасами
спиритизм --- спиритизм
спирник --- участник пиршества
спироначaльник --- полковник
спирствую --- радуюсь вместе с кем-л.
списатель --- писатель, сочинитель, описатель, переписчик
списую --- пишу, сочиняю, списываю, описываю
спитаюся --- наслаждаюсь, пирую или гуляю вместе с кем-л.
спица --- спица, спичка, острие
сплавати --- сопутствовать в плавании
сплачествую --- плачу вместе с кем-л.
сплеменник --- соплеменник, человек того же рода
сплетаюся --- схватываюсь, вступаю в рукопашный бой
сплина --- селезенка
сплинак --- пациент с больной селезенкой
сплошная неделя --- неделя, на которой нет постных дней
спленник --- взятый в плен вместе с кем-л.
сплясати --- ликовать, плясать вместе с кем-л.
споболети --- тужить, печалиться вместе с кем-л.
споборати --- воевать вместе с кем-л.
споборение --- союзничество на войне, 2. отряд воинов, соединенных щитами прикрывающихся
споборитель --- союзник, победоносный защитник
спогребаюся --- погребаюсь вместе с кем-л.
сподвижник --- соучастник в каком-л. подвиге
сподвизаюся --- подвизаюсь вместе с кем-л.
сподобляю --- удостаиваю, изволяю, благоволю
сподобляюся --- удостаиваюсь, получаю
сподобно --- удобно
сподобный --- соразмерный
спод --- из-под, 2. куча, группа
споение --- спайка
споеный --- спаянный
спожники --- Успенский пост
спожитель --- сожитель
споимати --- брать вместе с собой
споити --- спаять, соединить
споклоняемый --- поклоняемый вместе с кем-л., 2. принимающий равное поклонение с кем-л.
спокровенный --- сокровенный
спокрывати --- прикрывать, покрывать
сполин --- исполин, гигант
спомаати --- подавать знак движением головы, глаз или руки
споминаюся --- признаюсь, прихожу в себя, смиряюсь
спомогатель --- помощник
спомогательница --- помощница
спомогаю --- тружусь вместе с кем-л., помогаю в работе
спомощник --- помощник
спомянутися --- опомниться
спона --- препона, препятствие
спопирати --- топтать, попирать ногами
спори бывьше --- умножившись
спорина --- изобилие, богатство
споро --- обильно, богато
споручник --- поручитель, порука
споручница --- ходатаица
спореватися --- делать что-л. с рвением
спослушествую --- свидетельствую вместе с кем-л., подтверждаю свидетельство другого, слушаю вместе с кем-л.
споследник --- сопутник
споследница --- спутница, последовательница
споследствую --- сопутствую, сопровождаю, 2. запечатлеваю, изображаю
способник --- соглашающийся
способствую --- помогаю, защищаю, способствую
споспешник --- сотрудник, помощник
споспешница --- женщина, ободряющая к подвигу
споспешествую --- содействую, поощряю
спостник --- сподвижник, постящийся вместе с кем-л.


-------
Number of things where an exception was: 14801, 14811, 14856, 14899
Date of logging it: 2021-02-05T23:47:41 (by the time in UA).
