Date of logging it: 2021-02-05T23:47:41 (by the time in UA).
-------
[14901-15000]
спострадательный --- сострадательный
спострадательство --- участие в страдании, мучении
спострадаю --- страдаю вместе с кем-л.
споющий --- поющий вместе с кем-л., припевающий
справа --- подпись о верности судебной бумаги
справована --- отправляемы
спразднствовати --- праздновать вместе с кем-л.
спребыватель --- пребывающий вместе с кем-л.
спребывати --- присутствовать, находиться вместе с кем-л.
спреди --- спереди
спредстою --- являюсь вместе с кем-л.
спредстоятель --- предстоящий вместе с кем-л.
спреобразитися --- переиначить себя, преобразить вместе с кем-л.
спривлещи --- привлечь
спримешатися --- пристать, присоединиться к кому-л.
спримешаю --- соединяю, совокупляю
сприпрящи --- сопричислить, присовокупить
Сприсноцарствующий --- бесконечно царствующий (о Троице), участвующий в вечном блаженстве (о человеке)
сприседник --- соправитель в делах, сидящий рядом
спритекати --- притекать, приходить, прибывать вместе с кем-л., сходиться в одно время
сприемник --- помощник, пособник
сприимати --- принимать вместе с кем-л.
сприяти --- принимать вместе с кем-л.
сприобщати --- делать кого-л. участником в чем-л. вместе с другими
сприобщатися --- принимать участие вместе с другими
спросвещати --- просвещать кого-л. вместе с другими
спросвещатися --- просвещаться вместе с кем-л.
спрославляю --- прославляю вместе с кем-л.
спротяженно --- тщательно, аккуратно, усердно
спротяженный --- напряженный, усильный
сопрягаю --- соединяю, сочетаю браком
спрягаю --- соединяю, сочетаю браком
спрятоваю --- убираю умершего
спрятаю --- убираю умершего
под спудом --- в сокровенном месте
спуски --- резные украшения на древней утвари, идущие сверху вниз
спутешественник --- путешествующий вместе с кем-л.
спутия --- путы, узы
спутшествую --- сопутствую, путешествую вместе с кем-л.
спыти --- тшетно, напрасно
спесь --- спесь
спесивый --- спесивый, надутый
спех --- скорость, старание
спешуся --- спешу
спеюся --- успеваю, имею успех
спеяти --- возрастать
спяти --- покорить, повергнуть на землю
сравнительно --- сравнивая одно с другим
сраг --- строгий
срадую --- радуюсь вместе с кем-л.
сразитися --- дрожать, трястись, двигаться, 2. начаться, усилиться
сразоритися --- претерпеть общее несчастье вместе с кем-л.
сразрешитися --- освободиться от уз вместе с кем-л.
сразсмотрити --- рассмотреть вместе с чем-л.
сразсуждаю --- излагаю, выражаю, рассуждаю вместе с кем-л.
сразумеваемый --- признаваемый, почитаемый
срака --- сорока
срамлен --- срамный, постыдный
срамляю --- посрамляю, пристыжаю
срамоприобретно --- через срамное приобретение
срамота --- стыд, срам, 2. части тела, которые положено прикрывать
срамотити --- стыдить
посрамотити --- пристыдить
срамотно --- постыдно
срамно --- постыдно
срамотный --- непотребный
срам --- стыд, срам, срамота
срамяжливый --- стыдливый, целомудренный
срастворився неслиянно --- соединив в Себе Божественное и человеческое неслиянно
срасленно --- свойственно, прилично
срасленый --- сращенный, растущий вместе, соестественный, единосущный
сраспинаю --- распинаю вместе с кем-л.
срастворение --- слияние, смешение, соединение
срастворяю --- примешиваю
срастлевати --- повреждать, осквернять
срастлеватися --- оскверняться
срастение --- заживление
срачица --- хитон, покрывало, сеть, сорочка, рубашка
сребреник --- серебряная монета
сребро --- серебро, деньги
среброданный --- платящий дань серебром
среброделя --- мастер, делающий изделия из серебра
среброкузнеческий --- принадлежащий серебряных дел мастеру
сребролиятель --- серебряных дел мастер
сребролюбие --- жадность к деньгам
сребропродавец --- продавец серебряной утвари


-------
Number of things where an exception was: 14903, 14905, 14918, 14924, 14929, 14930, 14932, 14935, 14959, 14969, 14993, 14994, 14995, 14997
Date of logging it: 2021-02-05T23:49:57 (by the time in UA).
