Date of logging it: 2021-02-05T23:49:57 (by the time in UA).
-------
[15001-15100]
среброуздный --- имеющий серебряную узду
сревнитель --- соревнующий кому-л.
средняя порфира --- одежда под хламидой
средобольствовати --- быть в сродстве
средовек --- имеющий впалые щёки
средоградие --- средняя стена между владениями
средодневие --- полдень, середина дня
средонощие --- полночь, середина ночи
средопентикостный --- относящийся к преполовению пятидесятницы
средопостный --- средний в посте (день или неделя)
Средопятьдесятница --- преполовение пятидесятницы
средоречие --- земля между двумя реками
средостение --- срединная стена между владениями
средственный --- посредствующий
средствую --- нахожусь на середине, на половине чего-л.
срищуся --- сбегаюсь
срогость --- суровость
сродичи --- кровные родственники
сродник --- соотечественник, соплеменник, родственник
сродный --- родственный
сродствовати --- состоять в родстве
сродствие --- благородство, благородный вид, 2. родство
срока --- строка
срдьце --- сердце
срп --- серп
српьнь --- июль
срна --- серна
срсть --- шерсть
срша --- оса
срыдати --- рыдать вместе с кем-л.
срьдоведьц --- сердцеведец
срьдьба --- гнев
срезан --- усечен, изрублен, рассечен
срен --- белый
срет --- встретив
сречу --- стрекочу, покалываю, 2. подстрекаю, возбуждаю, поощряю
срею --- низвергаю
срядба --- сделка, условие
сряща --- встреча
срящуся --- являюсь, прихожу
срящ --- нападение, 2. припадок, несчастье, случай, 3. зараза, симптом.
ссарий --- ассарий, мелкая еврейская монета
ссельник --- поселившийся вместе с другими, сообитатель
сславити --- славить вместе с кем-л.
сстав --- судебные пункты
сступа --- схватка
сступитися --- сойтись вместе двум войскам
ссуден --- судящий или рассуждающий вместе с кем-л.
ссущественный --- одно существо с кем-л. имеющий
ссущие --- пребывание с кем-л.
ссущный --- понимаемый вместе с кем-л.
ссекаю --- секу вместе с кем-л. или сразу несколькими орудиями
ссечен --- заколот, убит
става --- сустав
ставец --- круглый сосуд с плоским дном
ставило --- подножие, 2. отвес, уровень, ватерпас
ставильное писание --- грамота от архиерея, вручаемая новопоставленному иерею или диакону
ставити на мзде --- производить в чин священства за деньги, творить симонию
ставленик --- избранный из клира человек, готовящийся к хиротонии в священника или диакона
ставраты --- деньги
ставропигиа --- водружение креста при основании нового храма
ставропигиальный --- подчиненный непосредственно Синоду или патриарху, и не зависящий от епархиального архиерея
ставрос --- крест
став --- пруд, 2. футляр для ножей и вилок
стадиотечница --- спортсменка, бегущая спринт
стадо --- стадо, 2. церковь Христова
стадоначальник --- главный пастырь
стазба --- пастбище
стай --- тотчас
стакти --- капля, 2. сок, 3. смола, ладан, смирна
сталый --- твёрдый, постоянный
стамед --- шерстяная ткань типа сукна, бархат
стамен --- деньги небольшой ценности
стамна --- сосуд, кувшин, урна, бокал
станица --- толпа, множество
станище --- стойло, хлев
становитый --- статный, 2. определенный, решительный
становище --- стан, станция, постоялый двор
становщик --- чиновник древней Руси, наименование которого происходит от полевого стана войска
стан --- состояние, 2. постоялый двор, гостиница, 3. жилище, комната, 4. полевой лагерь, стоянка
стание --- состояние
стап --- палка, трость, жезл, 2. вотчинная грамота
стареч --- стариков
старица --- старица, старуха, старая
старобытие --- давность, древность
старозаконный --- относящийся к Ветхому завету
староста --- староста
старостный --- земной, перстный, старческий
старощение --- волости под владением одного старосты
старцы --- начальники синагоги, 2. старцы, 3. старейшины
старчество --- книга изречений древних пустынников
старчий --- старческий, 2. принадлежащий или свойственный старцу
старый --- прежний, старший, старец
старейшина --- старейшина, начальник, вождь, князь, властелин, чиновник
старейшинство --- власть, начальство, старейшинство
старейшинствую --- начальствую


-------
Number of things where an exception was: 15005, 15057, 15076, 15080
Date of logging it: 2021-02-05T23:52:18 (by the time in UA).
