Date of logging it: 2021-02-05T23:54:35 (by the time in UA).
-------
[15201-15300]
страбити --- воссозидать, восстанавливать
страва --- похоронное пиршество у гуннов
страда --- жатва, страда, тяжкий труд
страдальный --- подверженный страданию
страдальческий --- мученический, страдальческий
страдальчествую --- подвизаюсь, веду подвижническую жизнь, страдаю, совершаю подвиг мученичества
страдальчествы --- подвиги
страдание --- подвиг, мученичество
страдательство --- сострадательность, милосердие
страдоба --- труды, старания
страдовьн --- пластовый (мед)
страдодавьц --- судья, дающий награду за подвиг
стражанин --- страж
стражать --- возделывать
стражбище --- сторожка, караульня, вахта, будка
стражду --- страдаю, мучаюсь, 2. много тружусь, 3. сношу, терплю, 4. подвизаюсь, подвергаюсь
стражебный --- относящийся к страже
стражик --- сторож, 2. стрелка весов, небольшой поход
страж --- страж, дозорный, 2. плод
странен --- отчужден
странник --- книга игумена Даниила
странничество --- странствование
странно --- удивительно, чудно, странно, невероятно
странноводец --- руководитель странников, попечитель о странниках
страннолепно --- дивно, чудно, непостижимо
страннолепный --- дивный, чудный
страннолюбивый --- любящий странников
страннолюбие --- любовь к странникам, угощение проезжих людей
страннолюбица --- принимающая и угощающая странников
странноненавистие --- жестокосердие, неприязнь к странникам
страннонравный --- склонный к странноприимству, свойственный странникам
странноприемлю --- принимаю странников
странноприемник --- принимающий странников
странноприемница --- дом для приема странников
странноприимство --- принимание странников, 2. дом для странников, 3. больница
странноприятися --- принимаемым быть во время странничества
странноприятство --- странноприимство
странноужасный --- очень страшный
странноявленный --- странный, необыкновенный
странноявляюся --- принимаю на себя вид странника, прихожу переодетым
странство --- странствование, 2. чужбина
странствую --- живу гостем, на чужбине, 2. странствую
странь --- цель для стрельбы
страстник --- распутный, развратный человек
страстница --- развратная, распутная женщина
страстной путь --- путь Господа на Голгофу
страстовати --- состязаться, бороться
страстолюбие --- любострастие, рабство страстями
страстолюбный --- сладострастный, предавшийся страстям
страстоносец --- победитель на играх, 2. пострадавший за Христа
страстоносица --- страдалица
страстоносие --- страдальчество за Христа
страстоположник --- главный из пострадавших за Христа, 2. судия, рассматривающий, кому из подвижников дать венец награждения
страстотворный --- возбуждающий страсти
страстотерпец --- мученик, претерпевший страдания от своих ближних во имя Господа
страстотерпческий --- мученический
страстотерпчество --- мученичество
страстоубийственный --- убивающий страсти
страстоубийца --- умертвитель страсти
страстьники --- сострадальцы, страдающие вместе
страстьства --- приключение, страдание
страта --- дорога
стратиг --- полководец, главный начальник
стратилат --- предводитель, военачальник, вождь, воевода
стратим --- мифическая птица
стратокамил --- страус
Стратонова башня --- Кесария Палестинская
стратопедарх --- военачальник, фельдмаршал
стратор --- конюх
страшливый --- боязливый, малодушный
страшу --- издеваюсь, ругаюсь
стребл --- крепкий, здоровый
стребляти --- потреблять, съедать, совершать
стрегу --- стерегу
стрекало --- жало, овод
стремглавный --- обращённый вниз головой
стремглаголяй --- любопрительный
стремена --- стремена
стреминный --- крутой
стремливо --- стремительно, быстро
стремный --- крутой
стрецати --- уязвлять
Стрибог --- языческий бог грозы
стригольники --- стригольники, еретики XIV века в Пскове и Новгороде
стрижьник --- постриженный клирик
строен --- пригоден на что-л., способен к какому-л. званию
строительно --- по благодатному устроению или распоряжению
строительство --- устройство, приведение в порядок, 2. домостроительство, домоправление
строй --- способ, устройство, наряд, покрой
строка --- дело, 2. место, 3. статья, 4. центр, 5. момент времени, 6. линия, 7. ряд слов в ширину страницы, 8. выпуклое шитье, 9. ряд чисел, определяемых по опр. закону
Строматы --- книга Оригена и Климента Александрийского
стромнина --- стремнина, крутая гора
стропа --- крыша, потолок, свод
стропове --- верхи строения, стропила, потолки


-------
Number of things where an exception was: 15217, 15229, 15235, 15236, 15238, 15242
Date of logging it: 2021-02-05T23:57:06 (by the time in UA).
