Date of logging it: 2021-02-05T23:57:06 (by the time in UA).
-------
[15301-15400]
стропота --- кривизна, шороховатость, 2. уклонение от истины, неправда, развращённость
стропотство --- кривость, строптивость, упрямство, запутанный узел, злое ухищрение
строптати --- шествовать окольными дорогами, 2. заблуждаться, поступать развратно
строптиво --- развратно, развращённо
стропчаю --- кривлю, делаю крюки в дороге
строфинг --- позвонок
строчица --- вертел, рожон, копье
строчное пение --- один из видов партесного пения
строчно --- ясно, определенно
строю --- устраиваю, привожу в порядок
струг --- орудие для строгания, 2. гребное речное судно
струдитися --- участвовать в трудах
стружем --- пытаемый путём скобления орудиями по телу
стружина --- стружка, опилки
стружу --- строгаю, скоблю, тешу
струити --- изливать струями
струпи --- раны
струп --- кора, струп на ране, болячка
струп плоти --- жало, боль
струфокамил --- мифическая птица
стручец --- помазок при миропомазании, елеосвящении
струя --- ток, поток
струфион --- страус
струф --- страус
стрбл --- твёрдый, крепкий, сильный
ебие --- тотчас, скоро, вдруг, 2. кстати, благоприятно
едение --- пища, еда, снедь
едро --- впадина, углубление, изгиб, 2. парус
едуч --- поедая
ед --- яд
едь --- пища, пропитание
еждение --- езда
ежженый --- бывший в употреблении при езде
езва --- язва, рана
ездовой --- ездовой, годный для езды (о коне)
ездок --- курьер для исполнения судебных поручений, посыльный
езд --- плата за отъезжий суд и разъезды, 2. прогонные деньги, 3. поездка, путешествие, дорога
езжу --- езжу, восхожу
ез --- вал, 2. рыболовный закол
еко --- что, тем что, вследствие того что, 2. как, каким образом, как бы, как будто, как если бы, не иначе, 3. совершенно как, словно как, как например, как будто бы, почти, подобно тому как, так что, так чтобы
ек --- какой, каковой
екже --- какой, каковой
ер --- строгий, суровый
если --- ясли, корыто, конюшня
ества --- яства, кушанье, блюдо
естовный --- пищевой, кухонный
еште --- ни
исад --- пристань, 2 рыбачья слобода, 3 место рыбной ловли. Есть вариант написания этого слова Ысадъ, причём это единственное слово на букву Ы в церковно-славянском языке
стрво --- труп, мертвечина, падаль
стргати --- скоблить, мучить
стрд --- мёд
стрк --- аист
стрх --- аист
стерх --- аист
стрптьн --- шероховатый, неровный, каменистый
стрываю --- стираю, сокрушаю
стрыечный --- происходящий от дяди или тети
стрый --- дядя, брат отца или матери
стребати --- прыгать
стрег --- подать, дань
стрекаю --- колю, боду
стрела --- стрела, луч
стреленый --- повергнутый из лука
стрелие --- расстояние полёта стрелы, пущенной из лука
стрелка --- валик или поясок, отделяющий грани шатра
стрелостоятельница --- осадная башня, с которой пускали стрелы
стрельница --- бойница, батарея, укрепление для стрельбы
стрельный --- употребляемый для стрельбы, реже - для тарана стен
стрельцы --- стрельцы, древнерусское воинство
стреляние --- стрела
стрета --- встреча
стрети --- стлать, расстилать
стреха --- крышка, кровля
стречнее --- счастливее
стрешти --- стеречь
стрюцкий --- презрительное именование подьячего, мелкого чиновника или дрянного человека
стряпня --- дело, занятие, должность, 2. утварь, 3. принадлежности одежды, 4. знаки царского достоинства, оружие
стряпчий --- должностное лицо типа царского камердинера
студеничный --- колодезный
студеное море --- Ледовитый океан
студенопитие --- холодное питье
студеность --- холодность, иногда - беспечность
студь --- стужа, холод
студит --- монах Студийского монастыря
студно --- гнусно, постыдно
студовидный --- гнусный, бесчестный, отвратительный
студодеяние --- постыдное, срамное дело, 2. распутная жизнь
студомыслие --- помышление о скверных делах
студословец --- сквернослов
студословие --- сквернословие
студ --- стыд, срам, срамное дело, 2. стыдливость, застенчивость
стужа --- холод, дрожь, 2. озноб, лихорадка
стужание --- докука, притеснение, досаждение, огорчение, горесть, мучение, негодование
стужаю --- докучаю, наскучиваю, досаждаю, тревожу, беспокою, смущаю, скучаю, унываю, стесняю, стесняюсь, утомляюсь
стужая --- притеснитель, угнетатель, 2. гонитель, враг, противник


-------
Number of things where an exception was: 15322, 15359, 15361, 15397, 15400
Date of logging it: 2021-02-05T23:59:22 (by the time in UA).
