Date of logging it: 2021-02-05T23:59:22 (by the time in UA).
-------
[15401-15500]
стулитися --- скрываться, прятаться, таиться
ступа --- тихий шаг
ступок --- тихий шаг
ступание --- поступь, поведение, поступки
ступень --- ступня, след ноги, 2. ход в игре
стыдение --- стыдливость
стыдетельный --- достойный уважение, т.е. которого нужно стыдиться из почтения
стырь --- руль
стьза --- дорога, стезя, улица
стькляница --- баночка
стьпль --- свинья
стбль --- свинья
стьбло --- свинья
стег --- стяг, знамя, хоругвь
стелесник --- принадлежащий одному телу, одному обществу
стена --- основание, покров, утёс, башня, крепость
стенатый --- огражденный стенами
стеноделатель --- создатель стен
стень --- тень
стеньник --- каменщик
стесняваем --- принуждаемый
стягиваю --- связываю, обвязываю, перевязываю, сжимаю
стягнути --- укрепить
стягнутие --- стягивание, скрепление, укрепление, 2. терзание человека
стяг --- воинское знамя, стяг, хоругвь
стяжаваю --- приобретаю, получаю, имею, употребляю, пользуюсь, принимаю, присоединяю, люблю, полагаю
стяжатель --- обладатель, господин
стяжаю --- приобретаю
стязаю --- стягиваю, скрепляю, укрепляю
стязаюся --- спорю, состязаюсь
стиракинов --- стираксовый
субботники --- субботники, сектанты
субботний --- субботний
Субботствование плотию --- пребывание Иисуса Христа во гробе
субботствую --- праздную субботу, реже - вообще праздную
Сува --- Сува, город Келесирия
сугмати --- настигнуть
сугубити --- удваивать, делать вдвое
сугубобытный --- двоякий
сугубомысленный --- двусмысленный
сугубопытный --- двоякий, двойной
сугубосотный --- двухсотый
сугубствие --- обоюдность смысла, хитрый оборот речи, двойственность
сугубы --- два
сугубный --- соответственный, приличный, 2. двоякий, двойной
сугустый --- густоватый
сударий --- илитон
судебница --- помещение заседания суда, судебное место
судебное поле --- площадь, где производилась расправа по суду
судитель --- судья
судительный --- судящий, судейский, способный судить
судище --- судебное место, судилище, 2. судебное дело, тяжба, судопроизводство, 3. судебное собрание, 4. судейское кресло, претория, дворец прокуратора, 5. ристалище, арена, 6. мученическое поприще
судищный --- судебный
судия --- судья
судки --- вид столовой посуды, в т.ч. перечница, уксусник
судно --- сосуд, 2. бок корабля
судове --- судебные решения
суеверие --- суеверие
суета --- хлопотливая и при этом безрезультатная деятельность
суетный --- тщетный, пустой, суетный, легкомысленный, безрассудный, 2. языческие идолы
суетство --- суетность
суетствую --- поступаю суетно, легкомысленно
суесловец --- пустослов
суесловивый --- пустословный
суесловный --- пустословный
суесловие --- пустословие, 2. высокомерие, самохвальство
Сузы --- Сузы, зимняя столица персидских царей
суй --- тщетный
суйм --- сейм
сукман --- кафтан или сарафан из крестьянского домотканого сукна
суковатый --- суковатый, сучковатый, весь в сучьях
сулея --- сосуд в виде бутыли
сулица --- дротик, копьё, пика
сулой --- сильное волнение
сулок --- плат на верхней части архиерейского посоха
сумбада --- мастика восточных цирюльников
сумежие --- граница, предел
сумежный --- пограничный, рубежный
сумляться --- сомневаться
сумняю --- предполагаю
сумняюся --- сомневаюсь
сумнюся --- сомневаюсь
сумневаюся --- сомневаюсь
сумрак --- сумерки
сунна --- сборник арабских преданий и толкований Корана, составленный в 840 г. Эль-Бохари
сунниты --- магометане, которых противопоставляют шиитам
суперинтендент --- главный лютеранский пастор в области
суперстицизиорес --- суевернейшие и бесобоязнейшие
суперстициа --- суеверие, суеверное богослужение
суплетка --- дело, связь, обязательство
супостатный --- неприятельский
супостатский --- неприятельский, вражеский
супостaтствовати --- поступать неприязненно
супостат --- враждебный, 2. враг, противник, неприятель
Супрасльский --- Супрасльский (Благовещенский монастырь)
супративник --- супративник, древнерусская монета
супротивие --- сопротивление


-------
Number of things where an exception was: 15471, 15476, 15478
Date of logging it: 2021-02-06T00:01:46 (by the time in UA).
