Date of logging it: 2021-02-06T00:01:46 (by the time in UA).
-------
[15501-15600]
супротивник --- противник, равный по силе
супротивный --- противостоящий
супротивоборитель --- противник
супротивословие --- противоречие, спор, противление
супротивохудожный --- соперничающий в художестве
супротивство --- сопротивление, нападение
супротив стояти --- противопоставлять, сравнивать
супруга --- супруга, жена, спутница, 2. пара, чета
супруги --- семейная пара
супружество --- супружество, брачное состояние
супружник --- товарищ, сотрудник, 2. супруг, муж
супружница --- супруга, жена
супружный --- мирянин, в противоположность монаху
сурик --- алая краска
Сурия --- Сирия
сурна --- древнерусский музыкальный инструмент, похожий на трубу
сурово --- жестоко, сурово, свирепо
сур --- герой, муж
сусло --- сусло, взвар, спускаемый при варении пива
суседи --- низшее сословие в Малороссии
сутана --- одеяние католического клира
сутки --- сутки
сутяжник --- тяжбу ведущий
суть --- сущность
сутьство --- природа
Суфир --- Офир
суходолие --- сухой овраг, безводный ров
сухолапль --- птица из породы чаек
сухонявый --- сухой, поджарый
сухота --- засуха
сухоядение --- употребление сухой и грубой пищи
сучец --- свежий отпрыск, 2. помазок для миропомазания
сушаница --- сушеное мясо или рыба
сушило --- сушильня, коптильня, 2. высохшее дерево
существовaтися --- принимать на себя существование
сущий --- действительный, настоящий, истинный, существенный
сущне --- истинно, подлинно
сущо --- воистину, 2. истинный
сфакел --- слово неясного значения, в т.ч. средний палец руки
сферовидный --- круглый, округлый, шарообразный, сферовидный
сфрагистика --- наука о печатях
сигиллография --- наука о печатях
сфунгато --- пирог, лепешка, блин
Схария --- основатель ереси жидовствующих
схизма --- раскол
схизматик --- вероотступник
схима --- высшая ступень монашества
схимлю --- облекаю кого-л. в схиму, делаю схимником
схимник --- монах, принявший схиму
сходни --- сходни, лестница, трап
сходник --- соглядатай
сходня --- лестница, трап
сходенька --- лестница
схождение --- спуск, схождение вниз
схождуся --- схожусь, 2. собираюсь, стекаюсь вниз
схоластик --- учёный, ритор, адвокат, учитель красноречия
схолиаст --- толкователь священного писания
сцарственник --- царствующий вместе с кем-л.
сцарствовати --- царствовать вместе с кем-л.
сцегло --- отдельно
сцеглый --- один только
сценение --- оценка, цена
сценять --- считать
счетаваю --- соглашаю, совокупляю, совмещаю
счетание --- поставление в одном чине, равночестие
счиневаем --- приводимый в порядок, в соединение
счиневати --- слагать, составлять
счинение --- собрание, сонм, 2. завещание
счисления способ --- способ счисления, отличный от современного общепринятого ряда натуральных чисел
счислитель --- переписчик населения
счислитися --- причислиться
счудиться --- сотвориться (о чуде)
счудоваться --- поражённым чудом быть
сшествовати --- сопутствовать, идти вместе с кем-л.
сшивати лесть --- замышлять лукавство, хитрость
сщипаю --- терзаю
свадити --- ссорить
свршение --- совершение
свет --- свет
свечати --- держать совет
свещевати --- совещаться, держать совет
сдрав --- здоровый
сжьвати --- сжинать
съигрыщ --- игра, пьеса
сыгришь --- игра, пьеса
скров --- тайный, крытый ход
слати --- слать, посылать
смрть --- смерть
смерен --- смиренный, покорный
сн --- сон
снедати --- съедать, пожирать, проглатывать, поглощать
снятися --- сойтись, собраться
Спас --- Спаситель, Спас


-------
Number of things where an exception was: 15512, 15529, 15532, 15536, 15542, 15555, 15571
Date of logging it: 2021-02-06T00:08:32 (by the time in UA).
