Date of logging it: 2021-02-06T00:08:32 (by the time in UA).
-------
[15601-15700]
срести --- встретить
ссадная --- пошлина, платимая чиновнику при отъезде после окончания дела
ссати --- сосать
сстав --- плод
сстояти --- помогать
ссць --- сосец
стварети --- творить, делать, совершать
сто --- сто
стьник --- сотник
сшественник --- спутник
сшд --- сошедши
съестный --- съедобный
сы --- ещё
сыворотка --- сгущенное молоко, простокваша
сыгрыш --- музыка, напев
сыновец --- внук, реже - племянник
сыновица --- внучка, дочь сына
сыновний --- свойственный или принадлежащий сыну
сыновство --- сыновнее состояние
сынолепно --- подобно сыну
сыноотечество --- еретическое слияние Бога Отца и Сына в единую ипостась
сынополагаю --- усыновляю
сынородительница --- родившая сына
сынотворенный --- усыновленный
сынотворимый --- усыновительный, усыновляемый
сынотворю --- усыновляю
сыпь --- плата вскладчину
сырище --- желудок
сырный --- относящийся к сыру
сырово --- любой сырой материал
сыропустие --- последний день масленицы, заговение перед великим постом
сыропустный --- относящийся к заговению во время масленицы
сысати --- свистать
сыта --- жидкий пчелиный мёд
сытник --- служитель, подносивший напитки из погребов чарочникам для подачи к царскому столу
сытость --- пресыщение, скука, утомление, обилие, множество, переизбыток, проклятие, обильный стол
сыть --- пища, корм
сь --- этот
сьга --- ныне, теперь
сьде --- здесь
сьде --- здесь
сде --- здесь
Сева --- Сева, богиня славян, варианты имени: Сива, Сиба
северныя двери --- дверь в алтарь слева от царских врат
север --- север, сторона холодных ветров, зимней вьюги и ночного мрака
седален --- седален, стих, во время чтения которого позволяется сидеть
седалище --- стул, место для сидения, лавка гребцов 2. кафедра епископа, престол, стол 3. задняя часть тела, 4. ложе, постель
седало --- стул
седатый --- седой
сединав --- седоватый
седети --- сидеть
секателен --- служащий для сечения
секира --- топор, пила
секу --- ударяю, рублю, тешу, обтесываю, рассекаю, разделяю, бросаюсь, кидаюсь, уязвляю
семена зарядная --- идущие на приправы
семенение --- осеменение, оплодотворение
семенный --- семя содержащий
семеноносный --- содержащий семя, возрождающийся от семени
семин --- раб
сенение --- отбрасывание тени
сени --- комната, покой, сени
сенница --- палатка, шалаш
сеннознаменательный --- знаменующий ветхозаветные обряды
сеннолиственный --- дающий густую тень
сенномудрый --- мудрый в разумении Ветхого Завета
сеннописание --- живопись
сеннопишу --- надрисовываю
сеннопотчение --- постановка палаток, праздник кущей
сеновно --- посредством теней
сеновный --- густой, тенистый, ветвистый, 2. прообразовательный
сеновьник --- сцена, публичность, показ
сеножатва --- луг
сериа --- казнь египетская, нашествие песьих мух
серядь --- рукоделие монашеское
сета --- сетование
сетный --- самый отдаленный
сетованный --- печальный
сетовный --- печальный
сеть --- сеть, тенеты
сеча --- битва, сеча, сражение, побоище
сечец --- воин с мечом
сечиво --- секира, топор, кол, меч
сечительно --- отрубая, отсекая, 2. резко, решительно, сильно
сечительный --- секущий, рассекающий
сечь --- моча, 2. язва, мор, 3. избиение, побоище, сражение
сечн --- январь
сечься --- рубить друг друга мечами, биться, 2. бичевать самого себя, 3. отделяться, расщепившись с конца, 4. рваться по нитям основы, 5. разделяться
сещи --- обтесывать камень
сещися --- разделяться, рассекаться, разбиваться
сеятва --- время сеяния
сеятель --- сеятель, 2. проповедник Евангелия
сюду --- сюда
сябр --- сосед, 2. совладелец, дольщик, пайщик
сябреный --- частичный, долевой, пайный
сягать --- доставать, хватать
сягнути --- достать, зацепить, 2. коснуться, дотронуться, осязать


-------
Number of things where an exception was: 15608, 15633, 15676, 15697
Date of logging it: 2021-02-06T00:10:49 (by the time in UA).
