Date of logging it: 2021-02-06T00:19:50 (by the time in UA).
-------
[16101-16200]
топаз --- топаз
топазий --- топаз
топархия --- областное правительство
топарх --- областеначальник, губернатор, полководец
топик --- туземец, земляк
топл --- теплый, тепло, теплеть, теплица
топор --- топор
топрво --- теперь
топтание --- топот
торак --- латы, панцирь
торгаю --- рву, тереблю
торговая казнь --- телесное наказание на торговой площади, при скоплении народа
торжище --- торговая площадь, народное сборище
торг --- торговая площадь, торговля, торговые дела
торжествую --- прославляю, торжественно вспоминаю, веселюсь, ликую
торжник --- меняла
торла --- булава
тороки --- дорожный мешок, привешиваемый к седлу
торок --- тесемка, лента, шнурок
тороп --- торопливость, поспешность
тороци --- слухи, особое внимание к вещаниям Божиим
Тор --- языческое божество древних славян
торьник --- скороход, гонец
торель --- тарелка, блюдце, блюдо, миска
тосетьне --- наконец, напоследок
тота --- княжна нагайцев
Тофет --- место в долине Генном к югу от Иерусалима
тохтуй --- кожаный чехол для лука
точный --- подобный, сходный, равный
точу --- изливаю, истекаю, источаю, проливаю
тощегласие --- пустословие
тощиться --- истощаться
травити --- питаться, есть, уничтожать
травлый --- косноязычный
травы --- узор на тканях
трагелаф --- животное из парнокопытных
трактамент --- обед, угощение
трактат --- трактат, учёное сочинение
трак --- тесемка, шнурок, лента
трапезник --- прислужник при храме
трапезный --- относящийся к трапезе
трапезование --- вкушение пищи
трапезофорон --- одежда на престоле
трапезую --- вкушаю пищу
трапезьница --- стол
трапление --- насилие, тирания
траур --- траур; время, одежда и обычаи печали по умершим
Трахонитская страна --- скалистая местность на северо-востоке от Генисаретского озера
требник --- жертвенник, 2. богослужебная книга
требогатый --- преблаженный
требует --- потребно, требуется, надобно
требуха --- требуха, потроха
требую --- нуждаюсь, нужду имею, 2. хочу, желаю, прошу
требе --- потребно, нужно, требуется
тревеликий --- безмерно великий
тревечерний --- три вечера находящийся
трегубительный --- весьма враждебный
трегубо --- трояко, тройственно, троекратно
трегубый --- тройной, троякий
треденство --- три праздничных дня
трезвение --- трезвость, бодрствование
трезвенник --- трезвый, бодрствующий
трезвенный --- воздержный
трезвлюся --- трезвость соблюдаю, умеренность, 2. бодрствую
трезвон --- звон во все колокола
трезвый --- трезвый, здравомыслящий
трезубый --- три зуба имеющий
трезубец --- трезубец, 2. пила, 3. молотильная телега с зубцами
треклитер --- окаянный, достойный проклятия
треклятый --- проклятый, проклятия достойный, пребеззаконный
трекровник --- третья кровля, третий этаж
трекровный --- три кровли имеющий, три жилья имеющий, трёхэтажный, находящийся на третьем этаже
треокаянный --- прежалкий, окаянный
треперити --- трепетать, трепыхаться
треперстие --- сложение трёх перстов для изображения крестного знамения
треперстное знамение креста --- крестное знамение православных христиан
трепетица --- дерево, возможно - тополь или осина
треплетенный --- сплетенный втрое
трепутие --- дорога, расходящаяся на три стороны
треска --- молния и гром
тресложный --- из трёх частей составленный
тресна --- тесьма золотая или серебряная, галун, бахрома
тресновитый --- шитый галуном, серебром или золотом
тресновица --- цепочка из галуна
треста --- солома, стебель
третина --- треть, третья часть
третины --- поминовение усопшего в третий день
третий час --- третий час, дневное богослужение
третьяк --- трехлетнее животное


-------
Number of things where an exception was: 16108, 16109, 16116, 16118, 16124, 16141, 16158, 16167, 16175, 16178, 16183
Date of logging it: 2021-02-06T00:22:07 (by the time in UA).
