Date of logging it: 2021-02-06T00:24:23 (by the time in UA).
-------
[16301-16400]
трудоприимьц --- переносящий труды
труждатися --- трудиться, заниматься работой
трунцал --- растянутая канитель, 2. шелковая нить, обвитая канителью
струнцал --- растянутая канитель, 2. шелковая нить, обвитая канителью
трупие --- мертвые тела, трупы
труп --- брюхо, живот, 2. стан телесный
трусный --- относящийся к землетрясению
трг --- торг
трзати --- рвать, терзать
тръпсиште --- народное собрание, площадь, рынок
трпети --- терпеть, переносить, выносить, мочь, удерживать
трса --- конский волос
трс --- виноградная лоза
трхть --- обломок, крошка, малость, 2. мелкая монета, лепта
трын трава --- волшебная трава
трыю --- тру, терзаю
трьн --- терн, терние, терновник, терновый
требити --- чистить
треба --- жертва
требьник --- храм, жертвенник
трева --- трава
трезв --- трезвый
трясавица --- лихорадка
трясавичный --- относящийся к лихорадке
трясение решета --- просеивание сквозь решето
трясило --- золотая шпилька с подвижной головкой
трясти --- потрясать, сотрясать
ту --- тут, там
Тубалкаин --- Фовел, сын Иафета
тяга --- тяжесть, печаль, забота, беда
туги самострельные --- древний вид самострелов или пращей
туде --- туда
туждий --- чужой
тужно --- скорбно
туземец --- туземец
тузлук --- украшение или часть пояса
тулумбаз --- небольшой бубен, в который били шариком на небольшой плети
тул --- колчан
туляться --- прятаться
тунаки --- рабочие-переселенцы на рыбных местах
тумашиться --- суетиться, хлопотать
тумим --- грудное украшение ветхозаветного священника
тунеядец --- тунеядец, дармоед
тупогрубый --- косноязычный
турить --- погонять, понуждать
турусы --- улусы, или подвижные жилища татар
тур --- тур, буйвол, зубр
туры --- оборонительные корзины
тутурган --- местное название какого-то злака, возможно, проса
тученосный --- производящий дождь
тщаливый --- тщательный, трудолюбивый
тще --- тщетно, напрасно
тщегласие --- пустословие
тщедушный --- измождённый, слабый, тщедушный
тощедушный --- тщедушный, слабый, изможденный
тщепогребальная --- истукан, статуя
тщеславие --- тщеславие, тщетная похвала самого себя, хвастовство, чванство
тщеславник --- горделивец, тщетно хвалящий самого себя
тщеславовати --- тщеславиться
тщесловие --- пустословие
тщеслововати --- празднословить, пустословить
тщетный --- суетный, напрасный, бесполезный
тщетство --- тщетность, суетность
тщетю --- убыток причиняю
тщивство --- беспокойство, уныние, 2. заботливость, 3. тщеславие, чванство
тщий --- тощий, пустой, ничем не занятый, порожний, напрасный, бесполезный, бездейственный, ничтожный
тщуся --- стараюсь, спешу
тгда --- тогда
тжде --- тот же самый
ткати --- ткать
ткмо --- если не
тло --- битая земля, пол
тпати --- топать
тт --- тот
тхор --- хорёк
тчити --- думать
тштитися --- спешить, стараться, обдумывать
тшть --- пустой
тщатися --- тщание прилагать, усердно стараться
тыков --- вид кубышки, сделанной из тыквы
тылеснь --- тупая сторона меча
тыл --- зад, тыл
тын --- плетень, изгородь
тысяцкий --- глава числового распределения городских жителей
тысяща --- тысяча
тысященачалие --- начальство над тысячью воинами
тысященачальник --- начальник над тысячью воинами
тыю --- тучнею, жирею
утыю --- тучнею, жирею
ть --- так, таким образом
тьзьство --- тезоименитство
тьньк --- тонкий


-------
Number of things where an exception was: 16306, 16311, 16318, 16321, 16342, 16351, 16394, 16397
Date of logging it: 2021-02-06T00:26:44 (by the time in UA).
