Date of logging it: 2021-02-06T00:26:44 (by the time in UA).
-------
[16401-16500]
тьсть --- тесть
тьшта --- теща
тедень --- неделя
телесный --- телесный
телесне --- телесно, свойственно телу
телище --- обладающее видом или подобием тела животного
телолюбивый --- пекущийся об украшении и насыщении тела
телотленный --- бренный, обреченный в плоть
телотучный --- утучняющий тело, питательный
тельник --- нательный крестик
темена --- темя во множественном числе
темже убо --- потому, и так
теск --- тесный
тесновмещаю --- помещаю с трудом, потому что тесно
теснею --- тесным становлюсь
тесто --- тесто, пирог
тешить --- забавлять, потешать, веселить, доставлять удовольствие
тешти пены --- испускать пену
теш --- орудия для потехи, увеселения
тюбетай --- шапочка татар
тюфяк --- осадное орудие
тябло --- часть иконостаса над царскими вратами с образом Спаса на престоле, реже - ярус
тягитися --- тягаться, состязаться, спорить
тягло --- оброк, подать, оклад, обязанность к военной или городской службе
тягненый --- вытянутый, выкованный из чего-л.
тяготный --- отяжелевший
тяжа --- спор, тяжба
тяжак --- земледелец, пахарь
тяжание --- стяжание, приобретение, 2. нива, пашня
тяжатель --- земледелец, фермер, арендатор
тяжати --- тянуть, весить
тяжаю --- работаю, тружусь, 2. снискиваю, приобретаю
тяжелоносный --- рабочий, вьючный, тяжелый для ношения
тяжемый --- возделываемый, обрабатываемый
тяжестный --- тяжелый, отяжелевший
тяжесть слоновая --- палата, украшенная слоновой костью
тяжкая --- благовест в большой колокол
тяжкий --- трудный, тяжелый, тяжкий, 2. лютый, свирепый, страшный
тяжкобременное --- тяжелая ноша
тяжконосие --- тяжелая ноша
тяжкосердый --- ожесточённый
тяжкотерплю --- переношу с трудом
тяжкоценный --- драгоценный
тяжуся --- спорю, сержусь, 2. тягаюсь, веду судебную тяжбу, 3. дерусь, бьюсь
тязати --- исследовать
тяклоименит --- тезоименит
тяклоименьн --- тезоименит
тяклоревьнитель --- прозвание апостола Симона Зилота
тяжцыи --- многочисленные
тяжце --- тяжелы
тяти --- резать
тятива --- тетива
тяшта --- денежный подарок
типикон --- типикон, богослужебная книга
Тирон --- прозвание св. великомученика Феодора
яблоко --- яблоко, 2. держава (один из символов самодержавия)
яблонь --- яблоня или апельсиновое дерево
явлей --- явившийся
явление --- явление, появление, очевидность, известность, слава
явленно --- явно, открыто, ясно, очевидно
явленнотворити --- открывать, обнаруживать, делать явным
явленый --- явный, открытый, славный, знаменитый, величественный, ясный, очевидный
явор --- явор, дерево
явотворити --- объявлять, делать явным
явственно --- явно, открыто, ясно, внятно, очевидно
явственный --- огласившийся, всем известный
явствую --- являю, проявляю, открываю, возвещаю, указываю
яве --- истинно, явно, открыто
ягня --- ягненок, козленок, агнец
ягодица --- лоза или кисть винограда с ягодами
ягодичина --- дикая смоковница
ягодичие --- сикимора, дикая смоква, 2. ягоды
ядение --- вкушение пищи, употребление в пищу, 2. еда, съестное, снедь, пища
ядовидно --- яду подобно
ядоглаголивый --- злоречивый
ядометный --- яд извергающий
ядомый --- съедаемый
ядоносный --- полный яда
ядрило --- мачта
ядца --- любитель поесть, сластолюбец
яд --- яд, отрава
ядь --- пища, кушанье, снедь
яждение --- езда
яжду --- езжу, еду, реже - иду, хожу, плыву
язва --- щель, расселина, 2. рана, 3. поражение, избиение, 4. рубец, шрам, 5. падалище, падаль, 6. полузажившая рана, язва
язвенный --- раненый, изрубленный, убитый
язвина --- нора, яма, пещера
яздящий --- всадник, ездок
языкоболие --- болтливость, злоречие, хула
языковредие --- злоречие
языковредный --- болтливый, болтун
языконевоздержание --- нескромность в речах, необузданность языка
языкоогнеобрaзный --- имеющий вид огненного языка
язычный --- многоречивый, злоречивый
язя --- немощь, болезнь
який --- каковый
яко --- как
яковый --- каковой


-------
Number of things where an exception was: 16406, 16467
Date of logging it: 2021-02-06T00:29:03 (by the time in UA).
