Date of logging it: 2021-02-04T19:58:06 (by the time in UA).
-------
[1701-1800]
напоминатель --- главный советник
напоследок --- потом, в завершение
напрасно --- внезапно, неожиданно
напрасный --- внезапный, резкий, крутой, суровый
нареченный --- званный, избранный, именитый
нарицати --- именовать, звать, называть по имени, реже - хулить
народ --- толпа, множество людей, народ
нарочитый --- знаменитый, именитый, особо почитаемый
насадитель --- садовник
население --- жилище, место обитания
насильник --- властелин
наслаждение --- услада, сладость
наставляти --- провести
настояние --- наступление, окружение
настояти --- наставать, наступать
настоящий --- нышешний
натканный --- набитый плотно, нагнетенный
наука --- научение, воспитание
научити --- воспитать
нахождение --- нашествие, нападение
начало --- начало, 2. основание, 3. глава, власть
началозлобник --- дьявол, виновник зла, первый по злу
начальник --- начинатель, владыка
начальство --- главенство, власть
начертание --- запись, изображение
начинание --- дела, занятия, образ жизни
нашествие --- нападение
небезбедный --- опасный
неботечник --- проходящий небеса
небрачный --- не знающий брака
небурный --- тихий
невечерний --- незаходящий, не знающий заката
невидимый --- невидимый, невещественный, не имеющий вида, образа
невиновный --- не имеющий внешней причины существования
невкусный --- непричастный чему-л., не вкусивший чего-л.
невлаемый --- безбурный
невнимание --- непослушание
невнятие --- непослушание
невредно --- невредимо
невредный --- невредимый
неверный --- не имеющий веры
невестник --- брачные покои, комната новобрачных
негодовати --- отвергать
недвижимый --- непоколебимый
недобрый --- негодный, неудобный
недоведомый --- непостижимый
недомысленно --- непостижимо
недомыслимый --- непостижимый умом
недоразумеваемый --- немыслимый, непостижимый разумом
недоуменный --- непознаваемый
недоумети --- не знать, не уметь, быть неспособным
недействительный --- бездейственный
неделанный --- необработанный, невозделанный
нежертвенный --- бескровный
незлоба --- непорочность, невиновность, 2. прямота, правота
незабвенный --- неотступный, всевидящий, от кого ничто не скроется
независтно --- изобильно, щедро
независтный --- обильный, щедрый
незаходимый --- неприступный; тот, в который нельзя войти
неизбежный --- тот, от которого невозможно бежать
неизменно --- неизменно, без изменений
неизследованный --- непостижимый, неприступный
неизчетный --- неизмеримый
неимение --- бессилие, беспомощность
неискусный --- недостойный, негодный, не выдерживающий искуса, 2. неопытный, не вкусивший чего-л.
неискусобрачный --- не вкусивший брака
неистовство --- безумие
неключимый --- негодный
нектому --- более не, уже не
нелестный --- правый, неложный, безобманный
нелестне --- бесхитростно
нелепый --- недостойный, безобразный
немерцающий --- немеркнущий
немимотекущий --- непреходящий, вечный
ненаветный --- защищённый от покушений
ненадежно --- без надежды, сверх надежды
ненадежный --- не имеющий надежды, 2. сверх надежды
ненаказанный --- невоспитанный, необученный, грубый
неначаемый --- нежданный, непредвиденный
неневестный --- не знающий брака
необъименный --- необъятный, беспредельный
необладанный --- не имеющий господина
необуреваемый --- недоступный бурям, надёжный (о гавани, порте)
неодержимо --- без опоры, без подпор
неодержимый --- непобедимый, каким нельзя овладеть
неописанный --- беспредельный, невместимый, 2. непредставимый, невыразимый
неопределенный --- беспредельный, безграничный
неоранный --- невспаханный
неплодный --- бесплодный
неподатный --- скупой
непорочный --- безупречный, целый, без физического недостатка, 2. чистый, без тяжких грехов
непостоянный --- невыносимый, против которого нельзя устоять
непостоятельный --- нестойкий
непоступный --- непоколебимый, несовратимый
непостыдный --- безбоязненный, неустрашимый
непотребный --- негодный, дурной, 2. ненужный
неправда --- несправедливость, обида


-------
Number of things where an exception was: 1707, 1715, 1762
Date of logging it: 2021-02-04T19:58:32 (by the time in UA).
