Date of logging it: 2021-02-06T01:10:18 (by the time in UA).
-------
[17001-17100]
усиняти --- освещать, просвещать
усклабляюся --- улыбаюсь, осклабляюсь
ускокорав --- кудрявый, курчавый
ускок --- скачок
ускоряю --- спешу на помощь, спешу
Услад --- божество древних славян
Ослад --- божество древних славян
услаждаю --- привлекаю, доставляю удовольствие, 2. приправляю для вкуса
услаждаюся --- наслаждаюсь, нахожу удовольствие
услуговавший --- послуживший чему-л.
услуговати --- служить, нести службу
услышати --- слушать, внимать, учиться, знать
усма --- кожа
усмарь --- кожевник
усменый --- кожаный
усмен --- кожаный
усмертити --- смерти предать
усморезатель --- сапожник, башмачник
усмошвьц --- башмачник, сапожник
усмотворец --- сыромятник, кожевник
усмотряю --- наблюдаю, смотрю с высоты
усмехливый --- веселый лицом, смешливый
усобица --- вражда, междоусобие
усовник --- брус, жердь, 2. покалывание в боку
усоветованый --- определенный, назначенный
усопший --- умерший
успший --- умерший
усох --- зубец на городской стене, 2. сухое место
успалка --- гнев
Успение --- Успение, мирная кончина, подобная сну, 2. погребение
успляю --- усыпляю
усповую --- усыпляю, обольщаю
успорити --- умножить
успети --- успеть, 2. поспеть, созреть
успешствовати --- успешным быть, получать пользу
усрехльство --- неровность, неправильность
усретати --- встречаться, сходиться, вместе идти на встречу
устна --- уста, рот, губы, 2. повеления
уставление --- установление, договор
уставляю --- утверждаю, устанавливаю, определяю, учреждаю, успокаиваю, убеждаю, утоляю, укрощаю, усмиряю, подавляю
уставник --- узаконитель, учредитель порядка
устаивати --- твёрдо противиться, выдерживать нападение, 2. преодолевать, побеждать, прекращаться
устат --- болтливый
устити --- науськивать, подстрекать, подучать
устие --- губы, уста, 2. нос, 3. берег, край, 4. отверстие, углубление
устнатый --- широкоротый, имеющий большие губы
устоети --- господствовать, повелевать
устраба --- отрада, 2. облегчение в болезни
устрабити --- возбудить
устрабление --- облегчение
устрабляю --- вырастаю, мужаю, 2. выздоравливаю, поправляюсь
устранноприимствовати --- угостить странника
устраншийся --- удалившийся в сторону
устратити --- отпускать, выпускать
устрашение --- страх, малодушие, 2. презрение, насмешка
устремаюся --- происхожу, выхожу, произвольно иду, пристаю, причаливаю, предпринимаю, приступаю
устремление --- стремительность, быстрота, 2. ярость, неистовство
устроение --- готовность, бодрость, смелость, сохранение, соблюдение, успокоение
Устрос --- Дунай
устрояю --- вооружаю, поставляю в строй, поправляю
устреляю --- попадаю стрелой, застреливаю, пронзаю, раню
устряти --- замедлять, задерживать, мешать
устужаю --- простужаю, прохлаждаю
усыпальня --- усыпальница, склеп, 2. кладбище
усыпаю --- засыпаю, 2. умираю
усыренный --- сыру подобный, тучный, жирный, плодоносный, орошённый
усыр --- сгущаю, пахтаю
усыряюся --- тучнею, жирею, делаюсь подобным сыру
уседк --- сосед
усекальницы --- щипцы
усекатель --- палач
усекаю --- отсекаю, отрубаю голову, казню
усекновение --- отсечение
усекновляю --- отсекаю
уселеет --- поселяет
усетити --- помнить
усечение --- нарезка, резьба
усеченый --- определенный, отсчитанный
усякальница --- щипцы, 2. ноздри
утакатися --- обуздывать, укрощать молодых лошадей
утата --- отсечена
утварие --- украшение, убранство
утваряю --- подкрашиваю
утверждатися --- упирать, ставить
утверждаю --- укрепляю, закаляю как сталь, заостряю, делаю твёрдым и острым
утворение --- украшение
утворяю --- устраиваю, привожу в порядок
утврдити --- утверждать
утекати --- убывать, утекать, убегать
утепаю --- бью, бичую
ути --- обуть
утискати --- содержать, заключать, сдерживать
утиск --- печаль, уныние


-------
Number of things where an exception was: 17025, 17026, 17031, 17042, 17046, 17069, 17071
Date of logging it: 2021-02-06T01:12:36 (by the time in UA).
