Date of logging it: 2021-02-06T01:14:52 (by the time in UA).
-------
[17201-17300]
ушкуй --- ладья, лодка
ушник --- серьга
ушничати --- наговаривать, наушничать
уштипък --- кусок, кусочек
ушь --- мох
ущедряю --- щедро награждаю, 2. сжаливаюсь, милосердствую, милость оказываю
ущерб --- ущерб, убыток, убавление
ущунить --- успокоить
уеда --- кушанье, пища
уедие --- снедь, пища
уезвити --- уязвить, ранить
уяденый --- укушенный, уязвленный
уязвляю --- раню, поражаю
уясняю --- озаряю, освещаю, 2. просвещаю, проясняю
уясняюся --- просветляюсь
уяти --- отнять, уменьшить, убавить
чавл --- гвоздь
чавка --- галка
чадо --- чадо, дитя, сын, 2. юноша, духовный сын, отрок, отроковица
чадолюбец --- любящий детей
чадолюбица --- любящая детей
чадоносие --- чревоношение, вынашивание плода
чадородие --- рождение детей, 2. христианское воспитание детей
чадотворю --- произвожу детей
чадь --- челядь, народ
чакати --- ожидать
чалдар --- конский убор из блях и ткани, закрывавший спину, бока и грудь лошади
чалма --- восточный головной убор
чан --- кадь, бочка, чан
чапрак --- нарядная попона
чемрак --- нарядная попона
чап --- пчела
чара --- чарка, полушарообразный сосуд
чарки --- род черевичек
чарование --- чародейство, употребление лекарств, отрав, колдовства
чаровати --- чародействовать
чаровник --- чародей
чародеец --- чародей
чаровный --- волшебный, заколдованный
чародей --- чародей, колдун, ворожей
чародейство --- чародейство
чары --- колдовство, чарование
часобитня --- башня с боевыми часами
часоблюдьц --- часовщик
часомеры --- часы
часослов --- богослужебная книга
частеначaльство --- начальство над частью народа
частик --- род сети или невода
частица --- участок, удел, владение, 2. маленький кусочек, частица
часы --- вид ежедневных богослужений, различают первый, третий, шестой и девятый час.
часьц --- мгновение
чахорда --- чехарда, игра с перепрыгиванием друг через друга
чаша --- чаша - сосуд и мера вместимости
чашник --- должностное лицо древней Руси, который был обязан сначала пробовать напитки, а потом подавать государю
чашница каменная --- строение
чашничать --- чашником быть
чаща --- чаща, густой лес
чащный --- густо ветвистый
чаяние --- ожидание, чаяние, предположение, надежда и страх
чванец --- фляга, кувшин
чван --- кувшин, жбан
чванчий --- виночерпий
чеботы --- чоботы, вид обуви
чеван --- смешанный, налитый для питья
чевер --- яд
чевьник --- белильщик
чез --- чрез
чекан --- ручное оружие типа топорика
чело --- лоб, 2. передняя часть женского головного убора
челка --- передняя часть женского головного убора
очелье --- передняя часть женского головного убора
челобитная --- просьба с низким поклоном до земли
человековидне --- в человеческом виде или образе
человекогубительный --- пагубный для людей
человекодельный --- сделанный человеком, артефакт
человеколепно --- свойственно или подобающе человеку
человеколюбезне --- человеколюбиво
человеколюбный --- человеколюбивый, имеющий любовь к людям
человеколюбствую --- оказываю человеколюбие
человекообразно --- в виде человека
человекословне --- свойственно человеческому слову
человекослужитель --- угождатель и льстец
человекоугодец --- угождатель, льстец
человекоявление --- тщеславное высказывание перед людьми
человек --- человек
чельник --- начальник
челядин --- раб
челядь --- домашние, домочадцы
чемарка --- одежда западных славян
чембур --- повод, узда
чемерит --- ядовитый
чемерь --- чемерица, ядовитое растение, 2. яд вообще
чепочка --- цепочка
чепь --- цепь
червень --- багряница, шелк темно-красного цвета
червечица --- болезнь, во время которой появляются черви
червии --- кожа, башмак


-------
Number of things where an exception was: 17228, 17229, 17266
Date of logging it: 2021-02-06T01:17:07 (by the time in UA).
