Date of logging it: 2021-02-06T01:23:49 (by the time in UA).
-------
[17501-17600]
хракати --- харкать
храмный --- храму принадлежащий
храмовая икона --- икона святого или праздника, памяти которого посвящен храм
храмской --- комнатный
храна --- пища
хранило --- стража, караул, 2. сундук, кладовая, хранилище
хранильная носящий --- суеверно носящий на себе всякие обереги для предохранения от неприятностей
хранителище --- суеверно носимые обереги, ладанки
хранитель --- градоначальник
хранительница --- покров
хранительный --- сохраняющий, способный хранить
хранити --- оберегать, стеречь, хранить
храштель --- перепел
хребет --- хребет, спина, тыл, шея, загривок, поясница, чресла, плечо, спина, 2. холм, бугор, курган, могила
хред --- кудрявый, волнистый
хрестный --- крестный
хрид --- холм, скала, утёс
хризма --- благовонная мазь, елей, миро
хрисовул --- царская и патриаршая грамота с золотой печатью
хрисолиф --- драгоценный камень
хризопрас --- драгоценный камень, зелено-золотистый
хризостом --- греческое именование св. Иоанна, переведенное на русский язык как Златоуст
христиане --- христиане, последователи учения Иисуса Христа
Христов день --- пасха, Светлое воскресенье
христодул --- почетное прозвание некоторых царей и вельмож Византии
христоименитство --- присвоение или ношение имени Христа
христоименитый --- носящий имя Христово
христокрaсно --- благозвучно во Христе или для Христа
христокрaсный --- красный строгим последованием учению Христа
христолюбивый --- любящий Христа
христомученица --- мученица за Христа
христоподобный --- подобный жизнью или подвигами Христу
христоподражание --- подражание Иисусу Христу
христоподражатель --- последователь Христу
христопроповедник --- проповедник учения Христова
христопроповедница --- проповедница, провозвестница о Христе
Христородица --- именование Пресв. Девы Марии, данное еретиком Несторием
Христос --- Христос, имя Спасителя, помазанник
хромец --- хромой
хронограф --- исторические сказания о судьбах мира
хрущатый --- плотный, толстый
хрк --- холм, насыпь, возвышение
хрзан --- бич
Хрст --- Христос
хрьст --- крест
хрены девотчии --- род дани, которую доставляли крестьянки
хтитор --- ктитор, покровитель, хозяин
хто --- кто
худогласие --- неблагозвучие, косноязычие
худогласный --- имеющий слабый голос или нечленораздельный выговор
худогий --- искусный, смышленый, умный, ловкий в писаниях, каллиграф
художне --- искусственно, хитрым образом
худородие --- низкое происхождение
худородный --- низкого происхождения, из простого народа
хула --- хула, уничижительный отзыв, злоречие, обвинение, осуждение
хуление --- злоречие, брань, осрамление кого-л. словами, 2. богохульство
хульник --- хулитель, богохульник
хульный --- поносительный, ругательный, богохульный
хулю --- порицаю, богохульствую
Хусий --- друг Давида
хухольник --- ряженый на святках
Хуш --- первый сын Хама
хжав --- благоразумный
хждав --- художник, мастер
хыжа --- хижина
хыжда --- хижина
хыжица --- хижина
хыза --- хижина
хыл --- гибкий, наклонный, непрочный, 2. слабый, дряхлый, больной
хына --- обман
хынити --- обманывать
хыра --- слабость, болезнь
хырети --- хиреть
хыштьник --- хищный, алчный
червленичный --- сделанный из красной шерсти
червленосветлый --- алого цвета
червленошaрный --- окрашенный багровой краской
червленуюся --- багровею
червленый --- багряный
червлень --- красное пятно
червоснеден --- червями заеден, источен
червчатый --- светлокрасный, малинового цвета
через --- кожаный толстый пояс на подкладке
черепаны --- черепки, битые горшки
череп --- череп
чересла --- чресла, поясница, крестец
чермен --- красный
чермнуюся --- краснею, красен бываю
чернедь --- чернь, простой народ
чернец --- монах
черница --- монахиня
чернечество --- монашество
чернечествовати --- иночествовать, вести монашескую жизнь
чернизина --- черное пятно
черничищ --- блудно прижитое дитя от монаха или монахини
чернобог --- божество древних славян
черноризец --- чернец, монах
черность --- мрак
черные люди --- название крестьян в древности
черный --- чёрный, 2. дьявол, нечистая сила


-------
Number of things where an exception was: 
Date of logging it: 2021-02-06T01:26:10 (by the time in UA).
