Date of logging it: 2021-02-06T01:28:24 (by the time in UA).
-------
[17701-17800]
чистолюбивый --- чистоплотный
чистость --- чистота, непорочность
чистота --- чистота, опрятность, 2. праведность, невинность, целомудрие, святость
чистотствую --- девство и целомудрие сохраняю
чить --- отдыхать, спать, почивать, 2. погребенным быть, покоиться
членовная --- челюсти, зубы
членок --- сустав
чловек --- человек
член --- член
члан --- член
чокма --- палица, колотушка, чекмарь
чолка --- пучок волос, прикреплявшийся к древку знамени
чох --- чихание
чпаг --- карман
чревобасник --- чревовещатель
чревоволшебник --- чревовещатель
чревоболение --- боль в животе
чревоболю --- страдаю (о роженице)
чревобесие --- объядение, обжорство
чревоволшeбник --- чревовещатедь
чревоволшeбство --- чревовещание
чревонеистовство --- обжорство
чревоносити --- беременной быть
чревоноситися --- вынашиваемым быть во чреве
чревоносная --- беременная
чревоношение --- беременность, 2. плод
чревообъядник --- обжора
чревоугодие --- пристрастие к лакомым блюдам
чревоугодник --- пристрастный к лакомствам
чревоугодница --- пристрастная к лакомствам
чревак --- саранча
чредник --- служитель, исполнитель череды
чреждение --- угощение
чрезсыть --- преизлишно, безмерно
чрез закон --- против закона, против права
чрепие --- черепки, черепица
чрепный --- черепичный, глиняный, 2. шероховатый, 3. на горе Херес
чреп --- черепок, кирпич
чресленник --- пояс
чреслина --- черешня
чреслити --- красить красной краской
чръвасьн --- окрашенный в красный цвет
чръвлен --- багряный, красный
чрвь --- червь
чръмьноватися --- красным быть
чрн --- чёрный
чрств --- твёрдый, плотный, черствый
чрта --- черта, чертить, очертание, чертеж
чреждение --- пир
чрем --- терем, палатка
чреновьный --- коренной зуб
чрепати --- черпать
чреп --- черепок, 2. череп
чтецы --- чтецы, низшие члены церковного клира
что яко --- почему, для чего, почто, что это значит
чту --- читаю, 2. почитаю, благоговею
чу --- междометие в значении \"слышишь\"
чуга --- узкий кафтан, удобный для путешествий и верховой езды
чудесный --- дивный, великолепный, торжественный
чудесоподaтель --- чудотворец
чудесоточный --- чудотворный
чудимый --- удивительный, досточудный, превосходный, дивный, богодухновенный, тот, которому удивляются
чудный --- удивительный, чудесный
чудо-юдо --- мифический змий
чудодейственник --- чудотворец
чудодействительный --- чудеса производящий
чудодействие --- чудотворение
чудодействовати --- чудеса творить, производить что-л. чудесное, сверхъестественное
чудодетель --- чудотворец
чудодетельне --- чудесно, чудотворно
чудодеяние --- чудотворение, чудо, чудесное дело
чудозрaчный --- чудесно изображенный, дивный видом
чудоносец --- чудотворец
чудоносный --- чудотворный
чудотворец --- чудотворец
чудотворный --- чудеса дающая, например, икона
чудоточный --- чудотворный
чудоточащий --- чудотворный
чудь --- великан, 2. финские племена
чудюся --- дивлюсь, 2. прославляю, благоговею, уважаю
чужделожник --- оскверняющий чьё-л. супружеское ложе
чуждемудренный --- разномысленный, 2. дурно мыслящий
чужий --- чужеродный, чужой, не свой, не свойственный
чуждопосетитель --- сплетник, смутник
чужеверный --- нехристианский, инославный
чум --- ковш для кухни
чурила --- один из солнечных богов древних славян
чур --- древнее мифическое существо
чую --- чувствую
чпр --- сук, ветвь
чпрь --- роскошь, удовольствие, деликатесы
чсти --- читать
чьстив --- богобоязненный


-------
Number of things where an exception was: 17709, 17760, 17770, 17771, 17773, 17774, 17779
Date of logging it: 2021-02-06T01:30:42 (by the time in UA).
