Date of logging it: 2021-02-04T19:58:32 (by the time in UA).
-------
[1801-1900]
неправедный --- несправедливый
непраздная --- беременная
непревращен --- не изменивший направления, не совратившийся в сторону
непрелестный --- неподвижный, не блуждающий (о светилах)
непременный --- подлинный, вечный, не знающий изменения, неизменяемый
непреподобный --- нечестивый
непреступный --- непреходящий
неприступный --- недоступный, недосягаемый
неприязнь --- зло, дьявол
неприятный --- чуждый, не принимающий, 2. неугодный
неработный --- свободный, не рабский
нерадити --- пренебрегать, не радеть
неразвратно --- несовратимо, несокрушимо
неразвратный --- несовратимый, неизменный
неразлучный --- нераздельный
неразоримый --- неразрушимый
нераскаянный --- неотменяемый, не подлежащий изменению
несветлый --- неясный, непрозрачный
нескверный --- чистый, неоскверненный, чуждый скверне
несносный --- непосильный
несосудный --- несравненный
несочетанно --- без брака, без мужа
несытный --- ненасытный, неутолимый
несытость --- ненасытность, пресыщение, обжорство
несытый --- ненасытный, алчный
несекомый --- неделимый
нетление --- неразрушимость, бессмертие
нетленно --- девственно, 2. вечно, 3. без истечения, не путём эманации
нетленный --- девственный, 2. неразрушимый
нетренный --- непроложенный (о дороге)
неудобный --- тяжёлый, 2. непонятный
неудобь --- тяжело
неумытый --- неподкупный
неуставный --- неудержимый, безудержный
нехотение --- ошибка, невольный грех
нечаянный --- неожиданный
нечестно --- нечестиво
нечувствие --- бесчувственность, невменяемость, неспособность к восприятию
нещадно --- щедро, не скупясь
нижний --- нижний, земной
нисхождение --- спуск с горы, склон
новый --- небывалый, сверхъестественный, чудесный
носити --- носить, переносить, 2. выносить, терпеть, 3. понимать, усваивать, 4. вынашивать плод (о женщине)
носитися --- относиться
нрав --- характер, поведение, образ действий
нудитися --- насилию подвергаться, браться с силой, 2. стараться, порываться
нуждатися --- тесниться, выбиваться из сил
нуждник --- насилие употребляющий
нуждно --- насильственно, очень сильно
нуждный --- насильственный, принудительный, 2. сильный
нырище --- развалины
недро --- грудь, 2. залив, бухта
мало --- мало, немного
малолетный --- недолговечный
маститый --- обильный, плодородный, тучный
масть --- миро, умащение, 2. масло
мерзкий --- ничтожный, никчемный
мертвенный --- смертный, 2. мертвый, мертвец
метание --- земной поклон
метати --- бросать
миловати --- щадить, жалеть
милостивно --- сострадательно
милостивый --- сострадающий, участливый
милость --- милость, 2. милостивый дар
милый --- жалость вызывающий
мимоити --- миновать, преходить
мирная --- жертва мира, примирения (род ветхозаветных жертв)
мирный --- мирный, относящийся к миру, противоположный войне
митрополия --- столица, царствующий город, митрополия
мирный --- мирской, принадлежащий этому миру
младенец --- ребенок моложе 7 лет
младоумный --- скудоумный
млачение --- молотьба
мнимый --- ценимый, почитаемый, 2. принимаемые за что-л., за кого-л.
многий --- пространный
многотрудный --- многострадальный
мнение --- самомнение, безумное превозношение, 2. видимость, иллюзия, нечто нереальное
мнети --- полагать, мнить, считать возможным
молва --- мятеж, смута, 2. суета, смятение, волнение на море
молвити --- смущаться, тревожиться, 2. увлекаться, суетиться, заботиться
моление --- мольба, прошение, 2. послы
молитва --- просьба, молитва
мощи --- силу иметь
мощно --- возможно
мрачный --- темный, 2. ложный
мудрование --- способность мыслить, образ мыслей
мудрствовати --- блюсти, придавать значение, 2. почитать
муж --- мужчина, человек, 2. взрослый, 3. супруг
мученик --- свидетель веры, исповедник
мучение --- месть, возмездие, 2. свидетельство
мучитель --- властитель, 2. палач, экзекутор, мучитель
мучительство --- деспотия, абсолютная власть
мыслити --- замышлять


-------
Number of things where an exception was: 1843, 1845, 1869, 1878, 1883, 1888, 1899
Date of logging it: 2021-02-04T19:58:57 (by the time in UA).
