Date of logging it: 2021-02-06T01:35:13 (by the time in UA).
-------
[18001-18100]
ший --- щи
шия --- шея
шкарпетки --- онучи
шкота --- ущерб, урон
шкофия --- скуфья
шкура --- кожа
шлык --- колпак, шапочка
шляг --- древнерусская монета
щеляг --- древнерусская монета
шелег --- древнерусская монета
шляхта --- польское дворянство
шнека --- вид корабля
шпак --- скворец
шпетить --- сильно уколоть словами
шпильман --- потешник
шпитальня --- богадельня
штав --- щавель
штедр --- щедрый, быть щедрым
штеньц --- щенок
шти --- шесть в родительном падеже
штина --- шестая часть
штирость --- щедрость
штир --- скорпион
штит --- щит
штобы --- хотя бы
штундисты --- штундисты, сектанты
штых --- удар острым концом холодного оружия
штядети --- беречь, щадить, копить, 2. пощада, 3. хилый, тощий
шуба --- шуба
шубаш --- вестовой
чауш --- вестовой
шуица --- левая рука
шуй --- левый
шумлю --- шумлю, оглашаюсь, произвожу шум
шушун --- крестьянская женская одежда
шяга --- кощунство
шятак --- дерзкий
шяхав --- шаткий, непостоянный
абаче --- впрочем, однако, но
Абессиния --- Эфиопия
абье --- тотчас, немедленно, вдруг
аблан --- яблоня
абсида --- алтарное полукружие с горним местом
абых --- чтобы, если бы, когда бы
авары --- тюркское племя
ават --- аббат, игумен
Августин --- Августин Блаженный
Авдий --- домоправитель Ахава
Авесса --- племянник Давида
Авессалом --- третий сын Давида
авеста --- собрание священных книг у парсов или гебров
авити --- открывать, обнажать, обнаруживать, делать явным, очевидным, показывать, выражать, раскрывать
Авилиния --- Авилиния, прилегает к Антиливану
авление --- явление, показание, видение
авось --- возьмем, положим, быть может
Авраамль --- Аврааму принадлежащий
авсень --- старинный весенний русский праздник
овсень --- старинный весенний русский праздник
автокефальныя церкви --- автокефальныя церкви, не подчиняются патриархам
автократор --- самодержец
Агав --- апостол из 70
агалмат --- статуя
агат-оникс --- двухслойный агат, удобный для резьбы портретов
Аггай --- город в Палестине
ангелогласен --- ангельский голос имеющий
агент --- действующий или говорящий за кого-л.
агиология --- учение о святых
агонисовати --- агонировать, находиться в агонии
агыос --- святой
адамант --- алмаз
адельфотис --- название первопечатной грамматики, изданной во Львове в 1591 г.
ади --- ешь (есть в повелительном наклонении)
адите --- ешьте (есть в повелительном наклонении)
Адония --- четвертый сын Давида
Адонаи --- имя Бога согласно пророку Исайе
ад --- ад
Азвяк --- Узбек, татарский хан
Азика --- город древней Палестины
азрастуй --- здравствуй
азы --- торки, народ
узы --- торки, народ
ай --- или
аль --- или
али --- или
Акила --- Акила, с женой Прискиллой оказали радушный прием ап. Павлу
Прискилла --- Прискилла, вместе с мужем Акилой оказали радушный приём ап. Павлу
ако --- если
акрогоний --- краеугольный
аксиа --- достойная, возглашается при произведении в игуменьи
аксиос --- достойный
акт --- акт, запись
акы --- как, как бы, так как
аламанин --- германец, немец
аланы --- аланы, скифское племя
алань --- гладкое травянистое место, выгодное для покоса и пастбищ
елань --- гладкое травянистое место, выгодное для покоса и пастбищ
алатий --- пальмовый
алатырь камень --- блестящий металл, сплав золота и серебра
албо --- или


-------
Number of things where an exception was: 18012
Date of logging it: 2021-02-06T01:37:28 (by the time in UA).
