Date of logging it: 2021-02-06T01:44:11 (by the time in UA).
-------
[18401-18500]
бирищь --- глашатай, герольд, бирич
бирка --- палочка с числовыми зарубками, служившая в старину в качестве долговой расписки
бирюк --- волк, 2. человек сурового взгляда и характера
бити --- бить
блаван --- столб
благим матом --- громко (кричать)
благий --- хороший, 2. дурной
благобъдрьн --- готовый, бодрый
благовидный --- красивый, 2. основательный (о суждениях)
благовременне --- вовремя, в надлежащее время
благовъзмагание --- сила, твердость
благовеинство --- благочестие
благовеинствовати --- относиться с особым уважением
благовестный --- евангельский
благогласнейше --- звучнее
благодаритися --- возблагодарить
благодарный --- признательный, дружелюбный, благодарный
благодaтельствоую --- наделяю, одаряю
благодатная --- благодатная (Богородица)
благодушно --- ловко, удачно, правильно, 2. в добром расположении духа
благозванный --- приветливый, ласковый
благоистесно --- легко
благоключимый --- благоприятный, удобный, 2. благоустроенный
благокознение --- доброе наставление
благолепие --- красота, украшение, пристойное убранство
благолепне --- достойно, пристойным образом, изрядно
благомьнение --- благоволение, доброе расположение
благонадежне --- смело, мужественно
благообразие --- благообразие, красота, украшение, благопристойность, благочиние
благопребытно --- благодушно, благосклонно, милостиво
благоприступление --- беспрепятственное приступание, постоянное прилежное при чём-л. нахождение
благоприемный --- благодушный, благосклонный
благопеснивый --- приятно поющий
благоразумен --- ясный, понятный, вразумительный
благоразумие --- благоволение, расположение, усердие
благословeнны --- разновидность тропарей воскресных дней
благословештение --- благословение
благословити --- хвалить, прославлять, превозносить, освятить, посвятить Богу, желать блага, счастия
благость --- доброта, благодеяние, доброе дело, готовность прийти на помощь
благоугоден --- приятный, весьма угодный
благоусeрдствую --- благосклонным делаю, умилостивляю
благочестиво устроити --- наблюдать благочестие
благочестие --- истинное почитание Бога, благоговение к Богу
благочестно --- благочестиво, благоговейно
блаже --- лучше
блаженнее --- полезнее, более угодно Богу
блажнение --- соблазн
блазенство --- шутовство, фиглярство
блазн --- ошибка
блевотина --- рвота, плевание
блеск --- сияние
блещание --- блеск, сияние
блещатися --- блестеть, сиять
ближник --- общее названние родственника, свойственника, ближнего, друга или приятеля
блистати --- блистать
блудник --- блудник, любодей, преданный похотям мирским
блудно --- беспутно, безнравственно
блван --- болван, истукан, идол
бльстети --- блистать, блестеть
блюдася --- остерегаясь
блюденье --- хранение
блюди еже молчати --- смотри, будь спокоен
блюдом --- соблюдаемый, сохраняемый, сторожимый
блюстель --- смотритель, наблюдатель
бобыль --- неимущий
богатчество --- богатство
богатество --- богатство
богатитель --- обогатитель
богатичищь --- сын богача
богатичь --- сын богатого
богатичьна --- дочь богатых родителей
богатный --- избранный, богатый, блаженный
богатодатно --- богато, обильно
богатый --- богатый, имеющий достаток во всем
боги --- боги, то есть силы, которым поклоняются язычники
богиня --- богиня
богиня неба --- Луна
богобойный --- богобоязненный
боговлъшьбьница --- волшебница, волхвовательница
боговещанный --- возвещенный Богом, 2. возвещающий или проповедующий о Боге
богоглаголиво --- по божественному откровению
богодуховный --- открытый Богом, от Бога внушенный
богодельный --- произведенный Богом
богознаменитый --- Бога возвещающий, 2. Богом возвещаемый
богозримый --- созерцающий Бога, проникающий в божественные тайны
богоизящный --- Богом предпочтенный, Богом объявленный
богокрмительн --- питаемый Богом
боголюбезне --- боголюбиво
богомилы --- вид гностиков, павликиан
богонапустный --- посланный от Бога
богоначально --- божественным распоряжением
Богоносец --- прозвание священномученика Игнатия Антиохийского
богоотметный --- отпавший от Бога, не признающий Бога
богоплетeнный --- Богом сплетенный
богоподобный --- достойный Бога, подражающий Богу, сияющий божественным блеском


-------
Number of things where an exception was: 18438, 18439, 18441, 18457, 18461
Date of logging it: 2021-02-06T01:46:29 (by the time in UA).
