Date of logging it: 2021-02-06T01:46:29 (by the time in UA).
-------
[18501-18600]
богопокорно --- внушением Бога
богорождение --- возрождение от Бога
богосиянный --- сияющий божественным светом, Богом явленный
богословеснейше --- богомудро, с высоким богословием
богословестие --- богословие, проповедование о Боге
богословие --- богословие, учение о Боге и наших отношениях к Нему
богослужение --- богослужение, совокупность священных действий и обрядов, посредством которых обнаруживаются религиозная вера и благоговейные чувства
богострастьник --- страдающий за Бога
богоуветливый --- умилостивляющий Бога
богоходный --- проходимый Богом
бограм --- байрам, магометанский праздник
баграм --- байрам, мусульманский праздник
Бог-Господь --- Бог-Господь
Бог-Слово --- второе лицо Пресвятой Троицы, Сын Божий, Иисус Христос
бодасто --- рог
бодро --- одно из качеств исполнения богослужебного пения
божат --- воспитывающий незаконнорожденных, иногда - крестный отец
божедомье --- место погребения неизвестных лиц за счет общества
божий --- божий, свойственный или принадлежащий Богу
Божий суд --- средневековый суд установления вины через испытание огнём, железом, поединком...
бой --- бой, битва, побоище
бойница --- отверстия в городских стенах для стрельбы
болван --- неотёсанный кусок, глыба, ком, чурбан
болгары --- болгары
болестин --- болезненный
болма --- больше
болонье --- пространство между двумя валами, защищавшими города
боль --- боль
больник --- больной
больничарь --- врачеватель больных
большити --- увеличивать, умножать
большой катихизис --- книга изложения веры в вопросах и ответах
большой чертеж --- карта Московского государства, изданная в 1613 году
большой угол --- угол горницы, где размещены образа
болезем --- болезнь
болезный --- несчастный, 2. тот, в котором принимают участие
болеры --- бояре
болярцы --- бояре
бомбицина --- писчая бумага из ствола хлопчатника и тряпья
бондарь --- бондарь, бочар
борбствую --- сражаюсь в рукопашную
бордун --- род меча или шпаги
борей --- северный ветер
боритель --- страшный враг, ратоборец, сокрушитель
борове --- боры, леса
боронити --- оборонять, 2. возбранять
боронь --- передовой отряд, 2. поле битвы
бортеве --- бортники королевских лесов в Польше
боры --- складки, фалды
Босфор --- пролив из Черного в Мраморное море
ботва --- зелень корнеплодных растений
ботети --- тучнеть
боязнь --- боязнь, страх
Боян --- древнеславянский "вещий" певец
боярские дворы --- вооруженные холопы, следовавшие за господами в поход
боярство сказать --- объявить торжественно пожалование в бояре
боятися --- страшиться, бояться, опасаться, ужасаться, трепетать, 2. почитать, чтить, 3. благочестиво служить Богу
брав --- скотина
брада --- борода
брадовь --- секира
бракопричастие --- бракосочетание
Брама --- Брама, первое лицо индийского божества Тримурти
брани --- враги
бранник --- состязание, спор, сражение
браный --- тканый
брателко --- брат
братив --- ласков, доброжелателен, общителен
братины --- древние металлические чаши
братия --- братия, иноки, христиане
братолюбец --- любящий брата, ближнего
братолюбие --- любовь к брату, к ближнему, 2. любовь между христианами
братр --- брат
братства --- общества лиц разных сословий для взаимопомощи
братчина --- увеселительный пир, устраиваемый вскладчину
брахмама --- бахрома
брачение --- брак
брашно --- кушанье, яство, 2. мука, ячмень, пшено, злаки
бревно --- бревно, срубленное дерево, жердина, балка
бредить --- беспорядочно мыслить
брежение --- наблюдение, тщание, прилежное смотрение, надзирание, старание
брежно --- аккуратно, прилежно
брезжиться --- светать
бресков --- персиков
Брест Литовский --- город в Гродненской губернии
брехание --- собачий лай, 2. грубый ответ
бречь --- беречь, наблюдать
брещи --- беречь
брещися --- беречься
бридкий --- острый, горький, гнусный
бридцайше --- пронзительно
брижение --- гнушение
бричь --- бритва, лезвие, острие
бровь --- бровь
бродитися --- переходить вброд
броды --- бродом
брозда --- удило


-------
Number of things where an exception was: 18506, 18576, 18577, 18580
Date of logging it: 2021-02-06T01:48:42 (by the time in UA).
