Date of logging it: 2021-02-06T01:50:59 (by the time in UA).
-------
[18701-18800]
белечьство --- звание бельца, мирянина, не монаха
беловати --- белеть, 2. белить, красить в белый цвет, 3. оправдывать
белоносити --- носить белую одежду
белообразный --- одетый в белое, беловидный
белообразую --- белую или чистую одежду ношу, наряжаюсь к празднику
белта --- белок яйца
белый клобук --- головной убор митрополита
белый царь --- прозвание царя Василия III
бельство --- белизна
белег --- знак
бество --- бегство
бесьскый --- бесовский
вабило --- связка гусиных перьев с куском мяса для приманивания ловчих птиц
ваганиться --- баловать, шутить, играть
вадлив --- сварливый, спорный
важать --- взвешивать
важдати --- наговаривать, обвинять
важный --- заслуживающий особого уважения, 2. веский
Валак --- царь Моавитский
Валтасар --- Валтасар, царь Вавилона
вал --- вал, земляная насыпь, 2. волна
валчеват --- кругловатый, округлый
вальный --- всеобщий, главный
вальсамелео --- бальзамное густое ароматическое масло
вальяжный --- полновесный, резной, красиво оформленный
вандалы --- грубый народ, смесь готов, аваров, славян и пр.
ванчус --- дубовый брус
вапенный --- известковый
варган --- музыкальный инструмент древней Руси
варение --- варка как процесс, 2. вареное кушание
варивотворьц --- повар
варити --- предварять, предупреждать, встречать
Варнава --- апостол из 70
варно --- жарко
варяги --- варяги, скандинавское или шведское племя
Варяжское море --- Балтийское море
Ватикан --- Ватикан, холм в Риме и папская резиденция
вбах --- правда, нужно признаться
вводитель --- виновник, провозвестник
вгажающе --- внушая
вдавати --- вверять, доверять
вдачь --- лицо, вступившее с другим во временные, как бы холопские отношения
вдаюся --- уступаю понемногу
вдругорядь --- в другой раз
вдежити --- вложить, вдеть
вдячно --- благодарно
веверица --- горностай или ласка
ведовица --- законная жена
ведряно --- ясная погода
веды --- священные индуистские книги
вежа --- башня при городской стене
везтися --- идти, пойти, держать, держаться
веле --- очень, весьма
велебный --- титул лиц духовного звания вроде \"преподобие\"
велевыспренний --- великий, возвышенный, очень высокий
велегласовати --- возглашать громко
веледействие --- великолепие
веледелание --- великолепие
велеможный --- великомощный, очень сильный
велерыбий --- китовый
велехвала --- гордыня, тщеславие
велинство --- великость
великовыйный --- надменный, гордый
великодаровный --- заключающий в себе великие дары
великоименитый --- весьма славный
великосхимники --- монашествующие, принявшие великую схиму
величатися --- величаться, прославляться, превозноситься, распространяться
величство --- величина, 2. величие, 3. величание
велий --- больший
вельблюд --- верблюд
вельможа --- вельможа, знатный человек
вельможный --- лицо дворянского звания
вельмысленный --- глубокомысленный
велети --- выражать волю, желание
вениса --- гранат (минерал)
Вениамин --- Вениамин
вервиния --- община с круговой порукой
веред --- чирей, прыщ, болячка
веречи --- бросить
верещать --- петь нестройно, кричать
верея --- столбы ворот, 2. небольшая легкая прибрежная лодка
вержение --- бросание, метание, 2. расстояние, покрываемое предметом, брошенным рукой человека
верзити --- метать, бросать, кидать
верижица --- цепь, ожерелье
Верникиа --- Вереника, дочь Ирода Агриппы I
Вероника --- Вероника
верси --- верх, верхи, верховные
верстать --- сравнивать, уравнивать
вертеж --- винт, тиски
вертеть --- вертеть, ворочать
вертоградарь --- садовник
вертопрах --- повеса, переменчивый человек
верховник --- крепость, верхняя часть города, 2. главное лицо, начальник
верхотина --- возвышение
вершить --- приводить к окончанию, решать
вершник --- верховой
вершь --- хлеб, жито, зерно
веряжане --- жители Новгорода


-------
Number of things where an exception was: 18742, 18772
Date of logging it: 2021-02-06T01:53:14 (by the time in UA).
