Date of logging it: 2021-02-06T01:53:14 (by the time in UA).
-------
[18801-18900]
веселил --- горд, спесив
веселие --- радость, веселье, 2. свадьба
весело --- весело, радостно, 2. скоро, поспешно
весел --- веселый
весельно --- весело, 2. смело, дерзновенно
веселяяй --- радующий
весна --- весна
ветчаный --- ветхий, старый
ветх --- ветхий
ветшь --- древность
вехт --- ветхий
вещепытание --- велеречие
вещный --- материальный, 2. обильный веществом, 3. мутный, пыльный
вещь общая --- республика
вжелети --- пожелать, иметь сильное желание
вжиляю --- укрепляю, утверждаю
взаим --- соответственно, соответственное
взаконивший --- законодатель
взаконити --- ввести кого-л. в разумение закона
взбрызгивание --- обрызгивание
взбурение --- шатание
взварец --- варенуха, напиток
взгарда --- надутость, превозношение
взголовье --- цилиндрическая подушка на царском стуле
взыгратися --- возвеселиться, взыграться
взяшася --- отверзлись (врата)
видитель --- зритель, очевидец
видковичи --- жители Новгорода
Видия --- Вена, столица Австрии
видь --- видение, вид
видельный --- познавательный, способный познавать
виж --- служитель при древних судах в Литве
викториальные дни --- дни празднования побед и заключения мира
вил --- языческое божество
вилы --- божества древних славян в роде русалок
Вильно --- Вильнюс, город
винды --- славяне к югу от Балтийского моря
винник --- виновный
винобер --- сбор винограда
виньство --- вина
вира --- пеня за преступление
вирник --- уголовный судья, взыскивавший пени в пользу казны
вирши --- стихи, преимущественно духовные
вити --- вить гнездо, 2. наматывать
витьскый --- судебный пристав
Вифавара --- Вифавара, местность, где проповедовал и крестил Иоанн Креститель
вколо --- около, вокруг
вкоповаю --- ввергаю
вкореняю --- укореняю
вкрасне ходити --- богато, щегольски одеваться
вкоупа --- груда, куча, ворох
коупа --- груда, ворох, куча
влагаюся --- попадаю, достигаю, прихожу
владательский --- государственный
владательство --- государство, правительство
владнуть --- овладеть
владуший --- владыка
владыко --- обращение к высшим иерархам
владычен наместнк --- лицо, поставленное Новгородским архиепископом судить во Пскове
владь --- волоса
влакно --- волокно
власность --- свойство предмета, принадлежность
власный --- собственный, свойственный
Власожельцы --- созвездие Плеяды
властные --- собственные
Власт --- постельничий царя Ирода Агриппы I
власяный --- шерстяной
влахи --- галлы
валахи --- галлы
влашской --- итальянский
влашть --- собственный
влаща творити --- присваивать
вложити --- положить, бросить, низвергнуть
вложитися --- дойти до бесчувствия
влга --- иволга
влк --- волк
влна --- волна, 2. овечья шерсть
влхв --- волхв, колдун, волшебник
вманити --- приманивать, увлекать
влы --- медленно
вместимо --- прилично, удобно
вместный --- удобовместимый
вмещемый --- бросаемый
вназвесть --- внезапно, неожиданно, нечаянно
внапрасне --- несправедливо
внемшийся --- занявшийся, загоревшийся
внимающий --- преданный, пристрастный
внутер --- внутрь
внедряю --- внедряю, скрываю
во --- иногда
водоность --- водонос, ведро
водоточный --- источающий, изливающий воду
водоточь --- река
водьнитися --- волноваться
во еже --- чтобы
вождевица --- предводительница
возблагословитися --- прославиться, возвеличиться
возбранительный --- препятствующий, отклоняющий


-------
Number of things where an exception was: 18809, 18817
Date of logging it: 2021-02-06T01:55:33 (by the time in UA).
