Date of logging it: 2021-02-06T02:00:06 (by the time in UA).
-------
[19101-19200]
вн --- вон
впити --- вопить, кричать
вплюща --- легкие, дыхательная ткань
вподверг --- в подброс
врста добрая --- чета, пара
вследьне --- остальное
вслеплют --- выныривают из воды
всповадити --- отъехать, возвратиться
всполети --- разгневаться
вспомничи --- докладчик
вспрятати --- удерживать, смирять
вспьрати --- полететь
вспятить троичь --- возвратить втрое
всрашати --- щетинить
всредь --- в середине
всрожати --- поднимать, будить, предвещать
встлапити --- удержать, обуздать
встодаание --- воздаяние
всырити --- свёртываться
втарь --- бочка
втвьрьдь --- твёрдо
вчати --- начинать
вштюдитися --- удивляться
взчудитися --- удивляться
вшца --- нарыв
вывезанье --- получение заново отчужденных ранее прав на землю
выдра --- выдра
выдрать --- похитить, вытащить
выжить --- нажить
выкупок --- выкупная запись
вылячи --- явиться
вымать --- вынимать, 2. брать что-л. запрещенное
вымирити --- исключить из мирного договора
вымо --- мимо
вымова --- красноречие, витийство
вымог --- вымогательство
вымол --- промоина, рытвина, овражек, 2. болото, 3. мельница, 4. пристань
вымя --- вымя
выправа --- приданое
мосаг --- приданое
выправлять --- выделывать
вырей --- земной рай, теплые края
вырок --- документ, по которому вышедшая замуж дочь лишалась права в наследстве родительского имущества
вырумовать --- прогнать из дома
выряжать --- включать в договор
выславлять --- восхвалять
выслуга --- имение, подаренное государем за военные заслуги
высокоглаголивый --- высокомерный
высоступцы --- ходули
выспа --- остров
выставлять в красилех --- изображать в красках
выстояние --- обложение, обступление
выступаться --- выступать, выходить
выступный --- виновный, преступник
выступ --- проступок
высылка --- отряд, толпа посланных куда-л.
вытекать --- военную вылазку делать
вытепать --- вырвать, выбить
вытечка --- вылазка
вытиниская --- всеобщая, обязательная для всех
вытруска --- лыко
вытручати --- вычитать, вычесть
выход --- дань, налог
вычение --- учение, наука
вышка --- высота, верхние полки, чердак
выштье --- окончание назначенного срока
вышшлетный --- предвечный
вьрети --- кипеть, течь
вьселичь --- во всём
вьселичьски --- всячески, всяким образом
вьсь --- деревня, весь
вьсямо --- со всех сторон
ве веве --- мы знаем
ве свеве --- мы узнаем
ведити --- велеть, сказать
ведовство --- волхвование
вежа --- башня при городской стене
веко --- род блюда наподобие подноса
векожизный --- вечный
векша --- белка, лесной зверек
Венечныя пошлины --- денежный сбор с брачующихся в древней Руси
венцы --- венцы, 2. украшения верхних краев
венчальное --- плата за венчание
венчальныя свечи --- венчальные свечи
верно --- благочестиво, с верой
вероятельный --- доверчивый, легковерный
верьник --- верный человек
весы святилища --- весы, установленные в скинии
ветиление --- болтливость
ветийствую --- проповедую
ветр --- ветер
ветьство --- колдовство
вечина --- верховная воля, закон, суд, приговор, решение, определение
вешть --- опытный, искусный, сведущий, 2. волшебник
вяжчее --- плата с господина за поимку его беглого холопа
вязень --- узник, пленник
вязь --- каллиграфическое искусство


-------
Number of things where an exception was: 19163, 19197, 19200
Date of logging it: 2021-02-06T02:02:23 (by the time in UA).
