Date of logging it: 2021-02-06T02:04:38 (by the time in UA).
-------
[19301-19400]
голубиная книга --- глубинная книга, то есть с глубокой премудростью: о сотворении мира, о природных явлениях
голубиный месяц --- первый месяц литовского календаря, соответствовал нашему апрелю
голубник --- голубятня
гол --- голый
голка --- шум
големоок --- большие глаза имеющий
голем --- большой
гонивый --- гнавший
гонозити --- избавить, исцелить
гончар --- гончар, горшечник
гон бобровый --- бобровая хатка
гоньфит --- дерево, дающее благовонный бальзам, росный ладан
гонезати --- избавляться, избегать
гораздньствие --- опытность, знание
горазно --- гораздо
горбавьство --- кривизна
горкость --- горесть
горничный --- горний
горностай --- горностай
горностал --- горностай
горносталюшков --- горностай уменьшительно
горняя --- место жительства Захарии и Елизаветы
городники --- строители городских стен, мостов и пр. в древней Руси
городница --- стенное укрепление из бревен или свай, наполненное грунтом или камнями
городчик --- надзиратель за исправностью городских укреплений
горский --- горный
горшеня --- гончар, горшечник
горшок --- горшок
горюха --- горчица
горети --- гореть
горешний --- вышний, горний
горянщина --- посуда и короба, сплавляемые с верховьев Поволжья вниз по течению
господа --- господин, 2. власть в Пскове, 3. суд, 4. двор
господарство --- государственное хозяйство, политическая экономия
господин --- начальник, властитель, хозяин, господин
Господоначaльник --- Господь Бог
гостебное --- торговые дела
гостивство --- пир, угощение
гостинец --- проценты, 2. проезжая охраняемая дорога
гостинная сотня --- купеческое сословие Древней Руси
гостиница великая --- большая проезжая дорога
гостинный двор --- строение, где жили купцы и хранили свои товары
гостиное --- одна из внутренних пошлин
государитися --- брать на себя государственную власть
готе --- жители Готии, или острова Готланда
готин --- болтливый
готов --- готовый, готов
грабеж --- один из видов наказания за преступление
грабити --- грабить, 2. грести, сгребать, погребать
грабиться --- добираться, выходить
градина --- огород, сад
градный --- градовой, причиненный градом
градодeржец --- градоначальник
граждь --- ограждение, хлев, конюшня
гражение --- строение
грамота --- указ, предписание, грамота в письменном виде
грамматика --- грамматика, 2. грамматика мусикийская - свод теоретических правил партесного пения
Грановитая палата --- Грановитая палата в Кремле
грань --- граница, межа, край
граяти --- говорить, издавать звук
гребсти --- пройти, продвинуться, проплыть
гремячий --- гремучий, гремящий
греческий роспев --- вид церковного пения
гридин --- младший дружинник при князе
гриф --- гриф, крупная птица
гроза --- гроза как явление природы, 2. опасность, беда, 3. строгость, 4. страх, угроза
грозн --- кисть, пучок
громник --- календарь со знаками зодиака и предсказаниями
громный --- громовой
гророве --- пузыри
грубный --- грубый
гружаю --- погружаю
грб --- горб
грд --- гордый
гркати --- ворковать
грличишть --- горлица
грло --- горло
грсть --- горсть
гртань --- гортань
кртань --- гортань
грыдоровальный --- гравированный
грызение --- угрызение
греза --- тина, грязь
гряздитися --- мерзнуть, коченеть
грязети --- погрязать
губной староста --- чиновник, заведовавший уголовными делами в округе
губский --- уголовный
губной --- уголовный
гугнанье --- ропот
гудок --- музыкальный трехструнный древнерусский инструмент
гуменник --- гумно
гумьно --- гумно
гуня --- одежда в виде плаща калик перехожих в русских былинах


-------
Number of things where an exception was: 19311, 19314, 19327, 19332, 19341, 19347, 19354
Date of logging it: 2021-02-06T02:17:21 (by the time in UA).
