Date of logging it: 2021-02-06T10:52:46 (by the time in UA).
-------
[19601-19700]
дмити --- надувать, наполнять воздухом, 2. делать гордым, надменным
дно --- дно, донце, днище, бездна
дска --- доска
дци --- дочь
дшти --- дочь
дштица --- дощечка для письма
дщерьша --- племянница
виска --- пытка дыба
Дый --- отец неба, языческое божество
дыффамовать --- бесчестить, бесславить
дыхающ --- дующий
дьбрь --- дебрь, лесистая долина
дьнь --- день
дьньца --- утренняя звезда
дьрз --- смелый, дерзкий
дьяки певчие --- члены церковного хора
дьяк --- чиновник, занятый письменным делопроизводством
деаньство --- деятельность
деваны --- древнеславянские богини
девствую --- девство сохраняю
дедичество --- наследие
действа --- вид архиерейских священнослужений
действенный --- действенный, на деле показываемый, спасительный, действительный
декание --- страсть
делавец --- работник
делити --- делить
дера --- дыра
детелье --- доброе дело
детеск --- древнерусский придворный чиновник
дети --- класть
детинец --- внутренняя часть города, куда горожане в случае опасности прятали самое дорогое
детский --- урядник с исполнительной властью
децкий --- урядник с исполнительной властью
евангелическое вероисповедание --- лютеранское вероисповедание
евонный --- ему принадлежащий, тот
евхологион --- молитвенник, сборник молитв
Евьжин --- Евге принадлежащий
еголь --- черепок от глиняной посуды
единец --- заяц
единовсельник --- поселившийся или живущий с кем-л.
единок --- одиноко блуждающий, 2. вепрь, кабан
единорог --- единорог, неуловимый зверь, в христианской символике - символ Христа
единород --- одинок
единость --- единство
единство --- согласие, единение
единьствитися --- соединяться
единыйнaдесять --- одиннадцатый
ежедней --- ежедневно
еж --- еж
езерища --- места, где были озера
елиньскый --- эллинский, греческий, 2. языческий
еллинисты --- евреи, родившиеся и жившие среди греков
Емерих --- Марс
емец --- должностное лицо, взимающее пошлину
ерик --- паерок, надстрочный знак в славянской азбуке
паерок --- надстрочный знак в славянской азбуке, предшественник апострофа
ендова --- сосуд для напитков, 2. глубокое место водоема
еруг --- овраг
ерыга --- подлый, беспутный человек
есаул --- есаул
Есевон --- Есевон, город в Палестине
есуть --- суть
есхада --- смоква
етериарх --- секретарь византийского императора
етунь --- ткань из египетского льна
ефадано --- престол
Ефрант --- Вифлеем, одно из названий
Ефрем --- город к северу от Иерусалима
жа --- же
жагель --- ветрило
жадный --- жадный, иногда - бедный
жалованье --- сожаление, соболезнование, ласка, 2. плата за работу
жаровый --- высокостволый
жарты --- кощунство
жаравый --- горящий
жасость --- беспокойство
жбан --- жбан
жбанчик --- жбан
жга --- жгучий ветер
жезл правления --- книга \"Жезл правления, утверждения, наказания и казнения\" написана в 1666 г. по поручению собора иеромонахом Симеоном Полоцким
желити --- желать
желтеница --- шафран
железныя ворота --- Дербент, 2. Уральские горы
жемок --- плач, сетование
женци --- жнецы
жерехи --- сушеная рыба на нитке
жестоковыя --- жестокосердие
жестокопребывание --- бедствия
Жива --- языческая богиня весны
живинский --- животный
животное всеплодие --- плоды, приносящие жизнь
жигати --- жечь
жизаги --- жечь
жилейка --- музыкальный инструмент
жира --- хорошее житье, довольство


-------
Number of things where an exception was: 19613, 19619, 19632, 19672, 19700
Date of logging it: 2021-02-06T10:54:08 (by the time in UA).
