Date of logging it: 2021-02-07T03:17:04 (by the time in UA).
-------
[19901-20000]
злострадание --- суровая жизнь
злоуменный --- злонамеренный
злохитрие --- способность к злому
злка --- золовка
змарагд --- изумруд
зможный --- возможный
змурна --- смирна
знадут --- знают
знайдоваться --- находиться
знаковина --- метка
знакомитый --- знаменитый, известный
знакомцы --- бедные дворяне, живущие из милости у бояр
знак --- знакомец
знание --- знакомые
знаньство --- знание
знатель --- знаток, сведущий
знатие --- знание
зневага --- ускорение
зный --- скудельный
зобмица --- мера сыпучих тел
Золотоноша --- город в Полтавской губернии
золотыя ворота --- ворота, через которые ходят крестные ходы
золь --- зло, грех
зорити --- проводить в зрелость
зороок --- порок в глазах имеющий
зрно --- зерно
зрьно --- зерно
зрьноберець --- питающийся зернами
зрети --- зреть, созревать
зрявкать --- зареветь
зрячее --- домашний скот
зсудиа --- ссуда
зухвамость --- дерзость
з --- из, от
здарь --- гончар
зложизние --- злополучие
зл --- злой, дурной
злч --- желчь
зль --- злоба
зльц --- злодей, дьявол
зыбляюся --- колеблюсь
зычить --- желать, благоприятствовать
зычный --- громкий
зьд --- глина
зьрети --- светить, блестеть, видеть
зедлость --- наглость
зело --- очень, сильно (др. рус.)
зябль --- произрастание, отрасль
зять --- молодой человек, родственник, зять
ивин --- ибис
играю --- торжествую
игрь --- игра
иговский --- принадлежащий ему, ей, им
игрушки --- род рыцарских потех
идольское обольщение --- идолопоклонство
иерей --- иерей, священник
ижевое --- очевидное, видимое
ижде --- где
изба казанская --- учреждение древней Руси, позже ставшее приказом
изба посольская --- учреждение древней Руси, посольский приказ
изба разбойная --- учреждение древней Руси, занимавшееся уголовными преступлениями
изба стрелецкая --- учреждение древней Руси, занимавшееся стрельцами, казаками и т.п.
избавление --- искупление
избавляю --- исторгаю, истребляю, 2. восстанавливаю, 3. сохраняю, предохраняю, 4. освобождаю
изберечь --- сбережение, сохранение
избеседовати --- произнести, сказать
изборивый --- предприемлемый
избрысовати --- стирать, сглаживать
избылый --- отсутствующий
изважать --- вывозить
изваятель златницам --- мастер, чеканящий монеты
известись --- доказывать свидетельскими показаниями
извисть --- известь
изводить --- сводить, сличать
извол --- произволение
извонский --- внешний, заграничный
извон --- вне
извопрошаю --- освобождаю от пытки
извну --- извне
изведую --- изучаю, исследую
извествуяй --- утверждающий в полном убеждении
изгодити --- выждать, улучить время, явиться, предстать
изгой --- вышедший, выходец
изгошити --- устроить
издаю --- выдаю, предаю, 2. покрываю, прекращаю
издвоитися --- разделиться надвое
издрешение --- выкуп, освобождение
изжедег --- сожегши
изказалисмо --- мы показали
изкерний --- искренний
излитие --- излитие, 2. излишество
излишие --- избыток
измлъсти --- выдоить
измотчи --- мочь
измочь --- одолеть
измъчьтати --- испестрить
изменьник --- меняла


-------
Number of things where an exception was: 19904, 19922, 19959
Date of logging it: 2021-02-07T03:17:30 (by the time in UA).
