Date of logging it: 2021-02-09T01:39:42 (by the time in UA).
-------
[201-300]
Жидовин --- Иудей
Жупел --- Сера
Зане --- Ибо, так как
Завет --- Союз, договор, завещание
Завещати --- Требовать, увещевать
Заповедь --- Предписание, приказ, наставление
Звательцо --- Знак придыхания
Зелие --- Трава, зелень, овощи
Зело --- Очень
Зиждитель --- Создатель, творец
Злачный --- Изобилующий травами, имеющий хорошие пастбища
Знамение --- Знак;
Зрак --- Вид, образ
Иго --- Бремя, ноша, ярмо
Изволити --- Захотеть, пожелать, предпочесть
Изгребие --- Лен, пакля
Изощряти --- Заострять, точить
Имение --- Имущество
Имярек --- Сокращенное обозначение, состоящее из двух слов, которое означает, что здесь следует назвать имя конкретного человека или святого
Иногда --- Некогда, в иное, прежнее время
Инуде --- В другом месте, где-нибудь
Искренний --- Ближний
Искусити --- Испытать, познать, делать пробу
Искушение --- Опыт, попытка;
Исо --- Сочетание острого ударения и придыхания
Исповедовати --- Объявлять, признавать;
Исповедание --- Прославление;
Исполнити --- Наполнять, насыщать
Исправити --- Устроиться, утвердиться, направиться
Испразднити --- Освободить, уничтожить, упразднить
Иссоп --- Мелкая трава, которая употреблялась для кропления жертвенной кровью
Истекати --- Выходить (ср.
Исторгнути --- Вырвать, извлечь
Исходище --- Источник;
Кадило --- Воскурение ладана, благовоние
Камо --- Куда
Камора --- Облегченное ударение
Келлиа --- Келья, жилище монаха или отшельника
Кинсон --- Подать
Клеврет --- Товарищ, соучастник, слуга
Клеть --- Комната
Книжник --- Толкователь закона, ученый человек
Князь --- Начальник, властелин
Ковати --- Готовить или замышлять недоброе
Козлище --- Козленок
Колико --- Сколько
Корысть --- Польза, выгода, добыча
Кошница --- Корзина, короб
Красный --- Красивый, прекрасный, превосходный, красный
Крепость --- Сила
Ктому --- Впредь
Купель --- Водоем, место для купания.
Куроглашение --- Пение петухов, время пения петухов
Кустодиа --- Стража
Лавра --- Крупный монастырь (греч. широкий, многолюдный)
Ланита --- Щека
Легеон --- Легион, отряд римского войска.
Лентион --- Полотенце
Лепо --- Красиво, пристойно
Лествица --- Лестница
Лесть --- Хитрость, коварство
Леть --- Позволительно, можно;
Лик --- Хор, хоровое пение, собрание
Лобзати --- Целовать
Лоно --- Грудь, чрево
Лукавое --- Злое дело
Лукавствие --- Коварство, хитрость
Льстец --- Обманщик, обольститель, соблазнитель
Маломощный --- Больной, немощный, увечный
Мание --- Мановение, знак, выражающий желание, волю
Мечтание --- Наваждение, призрак, воображение
Мзда --- Плата, воздаяние, награда
Мир --- Мир, согласие, тишина, покой, благополучие
Мир --- Мир, весь род человеческий
Миро --- Благовонная жидкость;
Мнити --- Думать, подразумевать
Моноксила --- Судно, выдолбленное из ствола дерева
Мрежа --- Сеть, для ловли рыбы или зверей, невод
Мысленный --- Относящийся к духовному миру
Мытарь --- Сборщик налогов
Мышца --- Рука, плече, сила
Назнаменовати --- Означать
Наипаче --- Более всего, особенно
Начаток --- Начало, первая часть чего-то
Невещественный --- Относящийся к нематериальному миру
Негли --- Может быть, возможно
Неделя --- Воскресный день
Недоумение --- Затруднение, смятение, смущение
Недужный --- Больной
Неже --- Нежели, а не
Незлобие --- Краткость, доброта
Неистов --- Иступленный, сумасшедший, беснующийся
Немоществовати --- Быть больным, хворать
Немощь --- Болезнь, слабость
Неплоды --- Замужняя бездетная женщина
Неподобный --- Нечестивый, неподобающий, непристойный
Непреложно --- Без изменения


-------
Number of things where an exception was: 221, 231, 266
Date of logging it: 2021-02-09T01:40:48 (by the time in UA).
