Date of logging it: 2021-02-04T20:59:14 (by the time in UA).
-------
[2101-2200]
исход --- выход, уход, исход, 2. книга \"Исход\"
исчадие --- потомство, 2. порождение, произведение
исчезати --- стремиться, страстно желать
за --- из-за, по причине, 2. от, прочь
заблудити --- заблудиться, потерять дорогу, 2. блуждать, скитаться
забрало --- бастион, застава
завистно --- по злобе
зависть --- недоброжелательство, злоба
заветный --- относящийся к завету
завещание --- увещевание, наставление, возвещение
задняя --- тыл, спина, то, что сзади, 2. прошлое
задети --- приказать, заставить
заимствование --- долг
заимствовати --- взаймы давать
заити --- уйти
заколение --- жертвенное животное
законный --- относящийся к закону
законоположити --- закон установить
закоснети --- промедлить
заматерети --- затвердеть
замедление --- опоздание
запечатлетися --- закрытым остаться
запинание --- пята
запинати --- препятствовать на пути, ставить подножку
запрещати --- угрожать, устрашать, возбранять, назначать наказание
запрещение --- угроза, 2. наказание,
запрещенный --- угрожающий
заря --- сияние, блеск, 2. отблеск
заступати --- защищать, прикрывать собой, покровительствовать
заступление --- защита, заступница (о Пресв. Богородице)
заступник --- защитник
заступница --- заступница (преимущественно о Пресв. Богородице)
зачинение --- установление
звание --- зов, крик, 2. призывание, 3. призвание, 4. призванные
звати --- взывать, 2. призывать, приглашать
звиздание --- свист, шипение, 2. посмеяние, издевательство
звиздати --- свистеть, шипеть
здание --- создание, творение, изделие
зима --- холод, 2. буря, непогода
зимность --- холод, стужа
зияние --- зев, раскрытая пасть
зияти --- широко открывать пасть
знаемый --- знакомый, друг
знаменательне --- образно
знамя --- знамя, шест с отличительным знаком
зной --- удушливый ветер
зрение --- созерцание
злая --- бедствие, 2. лукавство, зло
злоба --- зло, злодейство, лукавство, 2. бедствие, 3. забота, тягота
зловерство --- маловерие, недоверчивость
злодей --- преступник
злославие --- ересь
злый --- дурной, негодный
зле --- дурно, ложно, 2. тяжко
зельный --- сильный
зельне --- очень, с силой
единолетный --- годовалый
единомудрие --- единодушие
единомыслие --- внутреннее согласие
единообразный --- одного образа жизни (о монахах)
единородный --- единственный (о ребенке)
единствен --- единый (о Пресвятой Троице)
еродий --- аист
естество --- природа, законы природы
есть --- нужно (с дательным падежом), 2. 3 лицо настоящего времени единственного числа от глагола быти
жаловати --- жалеть, сокрушаться
жалостно --- горестно, гневно, с тяготой
жалость --- ревность
жезл --- побег, отросток лозы, ствол, 2. пастушеский посох, царский жезл, 3. дорожный посох, 4. палка для наказания
желание --- воля, жажда, 2. любовное стремление, 3. предмет страсти
жестокий --- суровый, трудный (для понимания и исполнения), 2. непокорный
живити --- оживлять, сообщать жизнь, животворить, 2. оставлять в живых
живоприятный --- жизнь в себя принявший
животное --- живое существо, всякое, в т.ч. бесплотное
живый --- ключевой (о воде)
жидовство --- еврейский закон, иудаизм
жила --- струна, тонкая веревка, нерв, 2. сухожилие, сустав, 3. водная жила, проток
жир --- пастбище, пажить, корм
жительство --- государство
жительствовати --- гражданство иметь, право постоянного проживания
жрети --- жертву приносить, 2. поглощать
жрец --- священник, жрец, приносящий жертву у алтаря
жупельный --- серный
дарование --- дар
движити --- беспокоить
дебрие --- долина
держати --- обладать, 2. властвовать, 3. соблюдать
дерзати --- ободриться, быть смелым, не робеть, 2. отважиться, решаться, 3. хвастать
дерзновение --- право свободного доступа, право обращаться
дерзновенный --- дерзкий, преступный
дерзостно --- смело
дерзость --- смелость


-------
Number of things where an exception was: 2104, 2107, 2123, 2128, 2130, 2135, 2166, 2194
Date of logging it: 2021-02-04T20:59:49 (by the time in UA).
