Date of logging it: 2021-02-04T22:01:14 (by the time in UA).
-------
[2601-2700]
аз --- я
азот --- Азот, город
азимиты --- опресносники, т.е. римляне, служащие мессу на опресноках
аилев --- по двое
аиромантиа --- аиромантика, воздуховолхвование, гадание по воздуху
аисе --- Аиша, жена Магомета
аин --- аин, 16-я буква еврейского алфавита
академицкий --- академический, принадлежащий высшему училищу
академиа --- академия
акакиа --- палочка, наполненная грунтом или песком
акакианы --- акакиане, еретики
акафист --- акафист
акафистотос --- Акафистотос, церковь во имя похвалы Пресвятой Богородицы
акелдама --- Акелдама, местность в Иерусалиме
аки --- как
аккарон --- Аккарон, главный город филистимлян
аколуф --- один из низших членов клира, прислуживавших епископу
акривиа --- заботливость, уверенность
акрида --- акрида, саранча
акила --- Акила, еврей родом из Понта
алавастр --- алебастр, гипс, изделия из алебастра, 2. круглый сосуд для хранения ароматов
алаи --- ассирийская провинция Алаи (Халах)
алгуй --- алоэ
александрийский --- принадлежащий жителям Александрии
александр --- Александр
александрянин --- родом из Александрии
алифис-влаверос --- одно из имён Антихриста
али --- но, ли, же, ужели, или, если
алконос --- Алконос, сказочная птица
алкание --- пост
алкиноядь --- хорошее кушанье, богатый стол
алоги --- алоги, еретики
алтарь --- алтарь
алфа --- альфа, первая буква греческого алфавита
алфеев --- Иаков Алфеев, один из 12 апостолов
алфеов --- Левий Матфей
алчу --- хочу есть
алчный --- голодный
амаггарий --- знак, цель, показание
амаликитяне --- амаликитяне, народ
амалфеев рог --- Амалфеев рог, имя одной из дочерей Иова
амвон --- амвон
амбросиа --- амброзия, божественный нектар, неистлеваемая пища
амефист --- аметист
амира --- эмир, князь
аминадавль --- Аминадавль
амма --- матерь духовная в монастыре
амма --- водотечь
аммореовы --- Аммореовы, стихиры в честь Богородицы
аммориа --- Аммориа, город во Фригии
аммонитяне --- Аммонитяне, народ
амнистия --- амнистия, прощение виновных
амносадикос --- Амносадикос, одно из имён Антихриста
амон --- Амон, царь Иудейский
амориа --- Амория, гора, на которой построен Иерусалимский храм
аморреане --- Аморреане, ханаанское племя
амос --- Амос, ветхозаветный пророк
амигдал --- миндаль
ананиа --- Анания
анафора --- возношение, приношение
анафема --- анафема
анафематствовати --- анафематствовать, отлучать от церкви
ангелозрачный --- подобный видом или сиянием ангелам
ангелоименитый --- знаменитый, почтенный в лике ангелов, 2) носящий имя кого-либо из ангелов
ангелолепный --- ангелам подобный красотой
ангелообразный --- ангела образ имеющий
Андрей Первозванный --- Андрей Первозванный, первый по времени апостол Иисуса Христа
анепсий --- племянник
аникит --- непобедимый (о чудотворном кресте)
антидор --- Антидор
антиливан --- Антиливан, гора на севере Палестины, противоположная Ливану
антиминс --- антиминс
антиохийский --- Антиохийский
Антиохия --- Антиохия
Антиох --- Антиох, царь
антипасха --- Антипасха
Антипатрида --- Антипатрида, город
антиптосис --- оборот речи, в котором один падеж заменяется на другой
антисикотиа --- суеверное лекарство в младенческой болезни
антифон --- антифон, т.е. стих, исполняемый попеременно двумя хорами
антихрист --- антихрист
Антипас --- Антипас, епископ Пергамский
Анхус --- Анхус, царь
анфологион --- анфологий, цветослов, собрание праздничных служб
анфракс --- карбункул, рубин
анфипат --- проконсул
апилеос --- апилеос, один из греческих месяцев
аполлион --- губитель, одно из имён дьявола
апоплексиа --- удар
апостата --- отступник
апостолодержательный --- апостольское учение держащий, или подражающий житию апостолов
апостол --- апостол
апостольски --- по примеру, по учению апостола
апофика --- погреб или житница для хранения нужных вещей; 2) аптека
аппиев торг --- площадь на расстоянии 50 миль от Рима
апракос --- недельный, т.е. евангелие и апостол в порядке дневных церковных чтений
априлий --- апрель
Арава --- Арава, равнина, по которой течет Иордан
Аравиа --- Аравия, северо-западная часть Аравийского полуострова
аравляне --- арабы, аравитяне, жители Аравии


-------
Number of things where an exception was: 
Date of logging it: 2021-02-04T22:01:54 (by the time in UA).
