Date of logging it: 2021-02-04T23:04:29 (by the time in UA).
-------
[3101-3200]
благостроение --- устроение, созидание
благостынный --- благодетельный, благостный, милостивый
благостынствовати --- благодетельствовать, благотворить
благосеннолиственный --- тенистый
благосенный --- тенистый, густую тень дающий
благота --- благость, доброта
благотворение --- благодеяние, доброделание
благотворити --- делать добро
благотерпеливый --- показывающий особое терпение, безропотный
благотерпети --- терпеливо, безропотно сносить
благотечение --- способность хорошо ходить
благотихий --- очень тихий
благоуветие --- снисходительность
благоуветливый --- сговорчивый, снисходительный
благоугождати --- делать приятно, угождать, нравиться
благоуготовляти --- приготовлять заблаговременно
благоузаконити --- сделать полезные установления
благоукрасити --- украшать великолепно, быть хорошо украшаемым
благоукрашение --- великолепное украшение
благоумиленный --- смиренномудрый, сердцем сокрушенный
благоумие --- благоразумие, здравый ум
благоуправляти --- управлять благоразумно
благоусeрдствовати --- много усердствовать
благоуспевати --- иметь хороший успех
благоустроевати --- приводить в порядок, в хорошее устройство
благоутварный --- хорошо убранный, украшенный
благоутишно --- безопасно от бури
благоутробный --- милосердный, милостивый, сострадательный
благоухатися --- исполняться благоуханием
благохваление --- добрая похвала
благохвалити --- воздавать великую похвалу
благохвальный --- хвалебный, заслуживающий великой похвалы
благохвально --- с великой похвалой
благохудожне --- весьма искусно
благоцвести --- находиться в цветущем состоянии, быть счастливым, процветать
благоцветный --- цветущий красотой
благочадие --- многодетность
благочадный --- многодетный
благочадствовати --- многодетным быть, иметь многих детей
благочествовати --- благоговеть, иметь благочестивые чувствования
благочестивне --- с подобающей честью
благочестивый --- набожный, благоговейный
благочинный --- священник, определённый от архиерея к наблюдению церковного благоустройства
благочтение --- полезное чтение
благочувственне --- с добрым чувством
благоязычный --- красноречивый
блажение --- блаженство
блаженник --- блаженный муж
блаженны --- вид стихир, читающихся на литургии вместе со стихами о блаженствах
блаженный --- благополучный, счастливый, 2) юродивый
блаженство --- благополучие, счастье, благосостояние, высшее удовольствие, 2) учение Христово из 9 предложений, произнесенное на Нагорной проповеди
блажити --- называть или почитать блаженным, 2) прославлять, возвеличивать, уважать, 3) делать счастливым, блаженным, 4) благодетельствовать, благотворить, обогащать, 5) делать вкусным
блазненно --- соблазнительно, преткновенно
блазнитель --- соблазнитель
блазнити --- соблазнять
блазный --- опасный
блазнь --- заблуждение
блато --- болото, тина, ил, грязь
блевота --- рвота, блевание
блекати --- блеять
ближика --- близкий родственник
ближичество --- приближённость
ближний --- следующий
близнец --- близнец
близно --- близко
близнята --- близнецы
близочество --- сватовство, свойство
близу --- вблизи
блистание --- молния, блеск
блуднический --- служащий для блудодеяния, 2) блуднический храм - это языческое капище
блудоборный --- боримый похотью, страстью
блудодействовати --- блудить, 2) уклоняться в язычество
блудодеяние --- блуд, внебрачная связь
блудокорчемница --- непотребный дом
блудолюбивый --- склонный к похоти, блуду
блудородный --- незаконнорожденный
блужение --- идолослужение, неверность Богу
бледость --- бледность, бледный цвет
бледый --- бледный, светлогнедой (о масти)
бледети --- бледнеть
блюдену быти --- быть соблюдаемым, сберегаемым, заключаемым
блюститель --- сторож, смотритель
блющ --- плющ
блядение --- вздор, пустяки, 2) словопрения, ругательства
блядник --- пустослов
блядословить --- лгать на кого-л., ругать кого-л., 2) злословить, порицать
блядословие --- болтливость, пустословие, 2) словопрения
блясти --- заблуждаться, 2) пустословить, 3) прелюбодействовать
богати --- служить
богатносветный --- сияющий великим светом
богатно --- обильно, изобильно
богатодарный --- щедрый, обильный


-------
Number of things where an exception was: 3113, 3120, 3123, 3128, 3130, 3175, 3179, 3195
Date of logging it: 2021-02-04T23:05:12 (by the time in UA).
