Date of logging it: 2021-02-05T00:11:15 (by the time in UA).
-------
[3801-3900]
возниспосылать --- ниспосылать свыше
возница --- кучер, извозчик, возница
возновляти(ся) --- восстанавливать, обновлять, возрождать
возносливый --- надмерный, высокомерный
возобладати --- начинать управлять
возображаю --- возобновляю, даю прежний образ
возоглавляю --- повторяю главное
возоглавление --- новое оглавление, новое указание
возопечалити --- опечалить снова
возопити --- возопить, закричать
возписати --- приписать кому-л., посвятить кому-л.
возпоставляю --- поставляю на чьё-л. место
возпряновение --- бодрственность, бдительность
возпящати --- запретить, препятствовать
возражаю --- опровергаю, ниспровергаю, возражаю
возрак --- вид
возрастити --- взрастить, растить, питать, укреплять
возриновен --- покачнувшийся, наклонившийся к падению, сдвинувшийся
возрождение --- возрождение, возобновление, перерождение
возрок --- извинение
возреяти --- поколебать, потрясти
возрютитися --- метнуться
возрядный --- высокий, поднятый вверх
возсвидетельствовати --- начать свидетельствовать, изобличить
возсвистати --- начать свистеть
возсилитися --- укрепиться, усилиться
возсиявати --- озарять светом, осветить
возскакати --- запрыгать, заиграть, начать скакать, заплясать
возскомлети --- ворчать, говорить тихо и с боязнью
возскрежетати --- заскрежетать зубами
возславитися --- прославленным быть
возславословити --- начать славословить
возсловие --- сходство, подобие
возследование --- порядок
возследователь --- последователь
возсмердети(ся) --- начать смердеть, сделаться зловонным
возсмеятися --- засмеяться, получить утешение
возсозидати --- воссоздавать, строить вновь, обновлять
возсопротивлятися --- противоборствовать, оказывать сопротивление
возспасаю --- возобновляю, восстанавливаю
возставление --- восстановление, приведение в прежнее состояние, возобновление
возставляю --- восстанавливаю, воскрешаю, воздвигаю, возбуждаю
возстание --- воссоздание, воскрешение
возстолпити --- вознести на столп
возстрадaльчествовати --- подвизаться снова
возступити --- ступить вверх, подняться
возсудити --- рассудить, рассмотреть дело
возустроити --- возобновить, переделать, сотворить заново
воз --- воз, повозка
вои --- воины, войско
воимже-воимже --- как потому, так посему
воинство --- войско
воинствоводец --- полководец, главнокомандующий
воинствословие --- воинский отряд
воистину --- справедливо, истинно, точно
вой --- воин, 2. дядя по матери
воление --- изволение, желание
волитель --- склонный, благорасположенный, преданный
волконравие --- лицемерие
волкохищный --- похищенный волком
волк --- человек жестокий, грабитель, сребролюбец, злонравный, обманщик
волнитися --- волноваться, обуреваться
волнобурный --- обуреваемый волнами
волняный --- шерстяной
волок --- волок, каток, 2. пространство между реками для волочения кораблей
волос --- имя славянского идола, по-другому - Велес
волхвование --- волхвование, назначение знахарских лекарств, прорицание
волхвовати --- пророчествовать, предсказывать, прорицать
вол --- вол
вольник --- избранник
волю --- хочу, желаю
воля --- соизволение, согласие
вонмем --- приглашение во время богослужения, означающее: внимательно будем слушать
воньже --- винительный падеж местоимения иже с предлогом в
воображаю --- восстанавливаю, возобновляю, возвещаю, прообразую
воображение --- изображение, образ, подобие, образец, пример
воополчаюся --- вооружаюсь
воочаю --- дарую зрение
вопление --- кричание, крик
вопленно --- с воплем, с криком
вопленный --- сопровождаемый криком, воплем, плачем
воплощатися --- плоть на себя принять, воплощаться
воплощаю --- даю плоть
воплощение --- восприятие плоти, воплощение
воплощенный --- телесный
вопльствити --- рыдать, громко плакать
ворей --- северный ветер от Гиперборейских гор
ворожба --- вражда
ворожбит --- враг
воронограй --- гадание по птичьему полёту
вор --- ограда из жердей
воскипети --- закипеть, наполниться
восклеветати --- клеветать на клеветника
воскликновение --- пение согласное и громкое


-------
Number of things where an exception was: 3811, 3816, 3821, 3826, 3887, 3894
Date of logging it: 2021-02-05T00:11:38 (by the time in UA).
