Date of logging it: 2021-02-05T01:12:15 (by the time in UA).
-------
[4201-4300]
вестно --- известно, ведомо
ветер тлетворный --- урон, опустошение, причиненное ветром
ветийствовати --- ораторствовать, красноречиво говорить
ветия --- вития, оратор, ритор
ветренник --- место, подверженное ветру
ветрец --- ветерок
ветроносец --- ветрогон, ветренный, легкомысленный, пустой человек
ветротление --- повреждение от ветра
ветротленный --- повреждённый ветром
ветры земские --- проповедники слова Божия
ветую --- витийствую, возвещаю, проповедую
вет --- уговор, совет
веть --- ветвь
вехть --- ветошь, тряпка
вече --- вече, народное собрание
вечную --- вечно пребываю
вечный --- вечный
вещание --- вещание, звук, речь, проповедь, слово, говор, 2. болтовня, пустословие, 3. весть, вестник,
вещаю --- говорю, проповедую, произношу
вещий --- мудрый, знающий
вяжу --- связываю, мучу, терзаю
вяза --- мучение, истязание, пытка
вязаница --- связка, вязанка
вязание --- смычка, плот, накат, пол, потолок, ярус, этаж, надстройка, 2. терзание, мучение
вящший --- больший, лучший
виссон --- род дорогостоящей ткани, а также бумаги, одежда из такой ткани
виссонный --- сделанный из виссона
гадов --- к Гадову племени принадлежащий
гаждателен --- уничижаемый, хульный, поносительный, заслуживающий порицания
гаждати --- поносить, хулить, злословить
Газа --- Газа, город
газарины --- гадатели по внутренностям животных, авгуры
газаринов --- сокровищехранитель
газофилакия --- казнохранилище
газ --- выделанная кожа, сафьян
Гай --- Гай, город
Галаад --- Галаад, гора за Иорданом
Галата --- Галата, слобода
галате --- галаты
галгала --- свержение
галеа --- галера
Галилеа язык --- Верхняя Галилея
галилеанин --- уроженец Галилеи
галица --- галка
гаман --- длинный кошель для денег
галун --- нарядная тесьма
Гаризин --- Гаризин, гора в Самарии
гасваринов --- казнохранитель, сокровищехранитель
гасилище --- орудие для тушения огня
гастримаргия --- чревобесие
гать --- плотина, насыпь, запруда
гвоздиный --- гвоздями пробитый
гвоздие --- гвозди
гвор --- пузырь
гда --- когда
гевал --- народ гевалитяние
геена --- место вечных мучений
геенский --- относящийся к геене или к вечным мукам
Галилейское --- Галилейское (озеро)
геометрия --- землемерие, геометрия
геонский --- мутный, нечистый
Герар --- Герар, город
Гергеса --- Гергеса, город
Гесем --- Гесем, область в Египте
Геф --- Геф, город
Гефсимания --- Гефсимания, роща у Елеонской горы, где молился Христос перед страданиями
Гиж --- коршун
гирло --- устье реки при впадении в море
глава --- голова, глава, верхняя часть, вершина, начальник, предводитель, нечто главное
главатица --- купол храма
главизна --- свиток, книга, 2. начало, основание
главица --- головка, маковка храма, капитель, 2. доска
главоприклонение --- склонение головы во время молитв, богослужений для выражения нашей покорности Воле Божией
главотяж --- головная повязка, наглавник
Главы Марковы --- Марковы главы
главы храмовые --- храмовые главы, дополнение к церковному уставу
глаголание --- речь, слова, молва, слух, поношение, посмешище
глаголанный --- сказанный
глаголати --- говорить, сказывать
глаголивый --- способный говорить
глагольный --- изреченный, изобразимый словом
глаголю --- говорю, рассказываю, приказываю, учу, проповедую, называю
глаголюся --- выдаю себя за кого-л.
гладивый --- ненасытный, жадный, хищный
гладный --- голодный, неплодородный
гладовати --- голодать
гладость --- голод, 2. плавность, приятность (о словах)
гладьство --- лихоимство, жадность к прибытку, алчность
гласование --- напев, приятная песнь
гластво --- обжорство
гласы --- особые напевы или тоны в церковной голосовой музыке
глафей --- валяльщик сукна
глашаю --- зову, кличу, называю
глашение --- отголосок музыкальной игры, зов
глашу --- раздаюсь, гремлю, распространяю звук
глежнь --- пята


-------
Number of things where an exception was: 4227, 4261, 4262, 4285
Date of logging it: 2021-02-05T01:12:40 (by the time in UA).
