Date of logging it: 2021-02-05T01:12:40 (by the time in UA).
-------
[4301-4400]
глездна --- громада, груда
гликизма --- густой сладкий отвар, пастила
глина --- глина
глина дробная --- старая глина, уже бывшая в употреблении
глоба --- казнь, наказание
глота --- толпа
глубоконощие --- глубокая ночь
глубокоречивый --- говорящий высоким слогом, или речами, имеющими сокровенный смысл
глубородительный --- рождённый из глубины, бездны, тьмы (о сотворении Земли)
глумилище --- игрище с бешеными плясками и скачками
глумлюся --- посмеиваюсь, пересуживаю, насмехаюсь, глумлюсь, праздно шатаюсь
глумный --- насмешливый, смехотворный
глен --- мокрота, слизь
глядати --- глядеть, смотреть
гнесь --- грязь, нечистота
гноеродный --- рождающийся в навозе
гноеименитый --- русский вариант имени императора Константина Копронима
гноеточив --- веснушчатый, 2. у которого глаза гноятся
гноити --- испражняться
гносимахи --- гносимахи, еретики
гностики --- гностики, еретики
гнусность --- гнусность. гнусное дело
гнусный --- гнусный, замаранный, нечистый, отвратительный
гнус --- гнусность, смрад, зловоние
гнусство --- гнусности, мерзости, идолы
гнушаюся --- отврващаюсь, презираю
гнев --- досада, ярость, гнев
гневодержание --- злопамятство, памятозлобие
гневодержательный --- злопамятный, памятозлобивый
гобзование --- изобилие, богатство
гобзую --- плодоносен бываю, приношу обильные плоды, изобилую, богатею, живу в довольстве
гобзующий --- богатый, счастливый, преуспевающий, торжествующий, надменный
гобзованный --- изобильный
гобзовати --- жить в достатке, изобиловать
гобзети --- благоуспевать
говение --- говение
говеиствовати --- чтить, почитать
говейный --- достойный уважения, достопочтенный
говеиный --- учтивый, почтительный
говею --- благоговею
говяда --- крупный рогатый скот, быки и коровы
говяжий --- говяжий, бычий, коровий
гоголь --- гоголь, утка-нырок
Гог --- Гог
година --- время, 2. час, 3. утро, 4. год
годе --- угодно, приятно
гой --- мир, тишина, прощение
Голгофа --- Голгофа
голень --- икра ноги
Голиаф --- Голиаф
голопупа --- неоперившийся птенец
голоть --- лёд, гололедица
голубица --- голубка
големо --- много
гольк --- рукомойник
гомола --- кусок, катыш
Гоморра --- Гоморра, город
гонзати --- избегать, утекать
гонзнути --- избавиться
гонитва --- гонение, преследование, 2. конское ристалище
гонотарь --- наколенник
гон --- погоня, 2. участок земли
гоню --- преследую, гонюсь, стремлюсь
гора --- гора
гора блаженств --- гора на северо-восток от Фавора, на которой Иисус произнёс Нагорную проповедь
гора высокая --- гора Фавор
гора Господня --- Гора Сион
гора достояния --- гора Мориа, где построен Храм
гора приосенeнная чaщи --- гора, покрытая тенью леса
гора смертоносная --- одно из названий города Вавилон
гординал --- кардинал
гордомудрствовати --- мудрствовать с гордостью
гордомудрый --- гордящийся мудростью
гордоносный --- производящий или вселяющий гордость
гордосильный --- гордящийся силой
гордостно --- надменно, с гордостью
гордыня --- гордыня, гордость, высокомерие
гордынный --- гордый, надменный
гордый --- гордый, надменный, жестокий, свирепый, проклятый, хвастливый
горлица --- дикий голубь, ласточка
горличище --- птенец голубя, 2. отверстие колодца
горло --- передняя часть шеи
горнец --- глиняный сосуд, горшок
горнило --- плавильная печь, горн
город --- город, 2. ограда, забор
горохищный --- изловленный на горах
горсть --- ладонь, горсть
гортанобесие --- гортанобесие, разновидность греха обжорства
гортань --- горло, из которого исходит голос
горушица --- горчица
горце --- горько, тяжко


-------
Number of things where an exception was: 4332, 4334, 4335, 4337, 4344, 4364, 4374, 4375, 4390
Date of logging it: 2021-02-05T01:13:03 (by the time in UA).
