Date of logging it: 2021-02-05T02:13:58 (by the time in UA).
-------
[4801-4900]
дол --- долина, межгорье, лог, желобоватая выемка
домашний --- домашний
домашняя церковь --- совокупность верующих во Христа и составляющих собой церковь
домец --- домик, хижина
домилище --- ветхий дом
домовь --- домой
домовитец --- хозяин дома, господин
домовладыка --- хозяин дома
домодержица --- хозяйка дома, госпожа
домоздaтель --- зодчий, архитектор
домоздaтельство --- строение дома
домородный --- рождённый и воспитанный в доме
домостроитель --- управитель дома или имения
домочадец --- рождённый в доме
домочадица --- рождённая в доме
домочадство --- домочадцы, слуги, рабы
домышляюся --- догадываюсь, угадываю, понимаю
донабдети --- наблюдать
донележе --- доколе, пока
донегде --- на некоторое время
допасти --- прилетать, прибегать, случаться
допасть --- обход, кругообращение, беспокойство
доправитель --- проводник, провожатый
допровадити --- проводить, доставить, довести
дора --- антидор
дорага --- татарский чиновник
дорник --- печатка для изображения креста на просфорах
дорога --- дорога, путь
дорогота --- дороговизна
дорок --- порицание, брань
дор --- земля, расчищенная под пашню
дориношение --- царская свита, оруженосцы
дориносец --- оруженосец, телохранитель
дориношу --- сопровождаю в качестве почетного стража
досадительство --- поношение, огорчающее слово или дело, обида, оскорбление, особенно соединенное с насилием
досити --- встретить, найти
доски --- древние записи и акты
досложение --- правильное сложение пальцев для крестного знамения
доспеваю --- достигаю, дохожу
доспех --- доспехи, вооружение воина
достижно --- достигая по возможности
достоблаженный --- достойный блаженства
достодивный --- достойный удивления
достодолжно --- по достоинству, по справедливости
достожеланный --- весьма желанный
достойнословлю --- прославляю
достойнопетый --- достойно прославляемый в духовном пении
достоит --- надлежит, следует, должно
достокан --- стакан, 2. драгоценный камень
достолепный --- достойный хвалы
достолепне --- достойным, подобающим образом
досторачительный --- заслуживающий особого внимания
достослышанный --- достойный слышания
достохвальный --- достойный похвалы или прославления
Калафур --- Камфора
Калежа --- Кадильница
Калежь --- Чаша
Календарь --- Распределение праздников и святых по порядку чисел месяца. Источником календарей послужили, частично, пасхальные таблицы, частично - сборники мученических актов, частично - диптихи, т.е. списки почивших членов церкви
Каленый --- Закаленный на огне
Калесати --- Звать, призывать
Калиги --- Обувь рода башмаков, надеваемая преимущественно на мертвых; сандалии
Калика --- Калека, урод, человек болезненный, нищий, слепец, ходящий по церковным праздникам и поющий духовные стихи
Калики перехожие --- Странники, побывавшие во святых местах; называются от названия их обуви (см.
Калило --- Каленое железо, уклад, сталь
Калита --- Кожаная сумка, кошелек
Калиште --- Грязь; место где лежит грязь
Калпак --- Высокая, к верху суживающаяся шапка, с узким меховым отворотом и с одною или с двумя прорехами, к которым прикреплялись пуговицы и запонки
Калугернца --- Монахиня
Калфа --- Это наименование усвоено в святцах по св. Иоанну (26 фев.). Калфа, слово означающее занятия святого: он был зодчий. Иоанн Калфа был замучен в Константинополе турками в 1575 г.
Кальный --- Замаранный, запачканный
Калья --- Похлебка
Каляти --- Осквернять, запятнать
Каляющеся --- Валяясь в кале
Камара --- Свод, кров; шатер, палата; комната
Камата --- Проценты, лихва
Каматьник --- Ростовщик, лихоимец
Каменарь --- Каменщик
? --- Пеня, наказание
Казаиние --- Проповедь слова Божия, или поучение, изустно сказываемое, наставление, увещание (польск.)
Казити --- Искажать (санскр. кас - вредить). Более употребляемое
Казньць --- Начальник воинского отряда;
Каменивржение? --- Бросание камней
Камение? горущее --- Сера
Камение --- Каменья, камни; утес, скала; острый кремень который может служить вместо ножа; мед каменный, тоже, что мед дивий - мед, дикими пчелами наношеный в расселину каменную; твердый камень, скала
Каменобиение --- Казнь, положенная в народе израильском на злодеев или великих законопреступников
Каменованти --- Побивать камнями
Каменовидный --- Твердостью подобный камню
Каменоделатель --- Камнетес


-------
Number of things where an exception was: 4801, 4807, 4810, 4855, 4862, 4869, 4873, 4875, 4877, 4894, 4896, 4898
Date of logging it: 2021-02-05T02:14:20 (by the time in UA).
