Date of logging it: 2021-02-05T03:14:51 (by the time in UA).
-------
[5201-5300]
еликий --- сколький, все, кои, каковой, сколь многий
елико --- сколько, как можно скорее, недолго
Елим --- Елим, стан евреев в пустыыне Сур
Елисавефь --- Елизавета
Елиссей --- Елисей
еличество --- количество
Елиа --- новое римское название Иерусалима после его разрушения императором Титом
Елиезер --- старший слуга Авраама
Эллада --- Эллада, Греция
Еллима --- Еллима, волхв, упоминаемый в книге Деяний
еллинский --- свойственный древнегреческим мудрецам, язычествующий
еллинство --- язычество, многобожие
еллинствовати --- многобожником, язычником быть
эллины --- греки, реже - все язычествующие
елма --- так как, когда уже
Еман и Ефам --- начальники хоров при Давиде
Емаф --- локоть, 2. город Емаф
емвол --- мыс, 2. дельта реки
емек --- долина
лемеш --- сошник
емлю --- беру, собираю, снимаю, ловлю
Еммануил --- Эммануил
Еммаус --- Еммаус, селение близ Иерусалима
емпуза --- страшилище, кикимора, ведьма
емствовати --- взять
емь --- взяв
Еннон --- Еннон, долина, где приносили жертвы идолу Молоху
Енон --- Енон, местность, где крестил Иоанн Предтеча
Енотикон --- писание
енфоф --- ожерелье, бусы
Енос --- Енос, сын Сифа
Енох --- Енох, ветхозаветный патриарх
епакта --- дни в году, с которых начинается солнечный год
епархиа --- область или уезд, подчинённый главному городу
епарх --- комендант крепости, областеначальник
Епафрас --- Епафрас, из 70 апостолов, первый епископ Колосс
Епафродит --- Епафродит, из 70 апостолов, епископ города Филиппы
епендит --- одежда, плащ
Епенет --- Епенет, из 70 апостолов, епископ Карфагенский
епиват --- безымянный палец
епигонатий --- святительская одежда
Эпикур --- Эпикур
епископ --- епископ
епископия --- область, управляемая епископом, епархия, 2. храм с архиерейской кафедрой, 3. власть, звание епископа
епископство --- власть духовная
епископь --- епископский
епистолиа --- письмо
эпитафия --- эпитафия, надгробная надпись
епитимия --- епитимья, духовная наказание или упражнение для преодоления греха
епитрахиль --- епитрахиль
епифа --- епифа, название месяца у египтян
епомида --- одежда первосвященника и царя
Эраст --- Эраст, из 70 апостолов
Ердань --- Иордан, река
ересь --- ересь, лжеучение
еретик --- еретик, последователь ереси
еретичество --- раскол на основе ереси
еретичествовати --- ереси следовать
ерехий --- лоскут от одежды
еринния --- мука, мучение
Ерма --- Ерма, из 70 апостолов
Ермий --- Ермий, из 70 апостолов, епископ Далматии, 2. греческий бог
Ермон --- Ермон, горный хребет
Ермониим --- многохолмие
есенный --- осенний
есень --- осень
есефим --- дом совета
есмирнисменный --- смешанный со смирной
еспер --- вечерняя звезда
ессеи --- ессеи, иудейская секта
естественножизненный --- поддерживающий жизнь, дающий необходимое для жизни, составляющий начало жизни
естественный --- естественный, природный
етер --- некоторый, некто
Ефес --- Ефес, город
ефи --- эфа, мера сыпучих тел
ефимерии --- чреда
мефимоны --- вечерние службы с понедельника по четверг первой недели великого поста
ефов --- крокодил
ефод --- верхняя одежда первосвященника
Ефремов --- Ефрему принадлежащий
ефуд --- часть облачения ветхозаветных священников
еффафа --- разверзься, отверзься
ехидна --- ехидна, змея ядовитейшая
Ефам --- Ефам, один из еврейский мудрецов
Эфиопия --- Эфиопия
Эфиопс --- эфиоп, житель Эфиопии, 2. чернокожий, 3. дьявол
еврип --- пролив морской
евфратский --- радостный, вожделенный
Евфраф --- древнее название Вифлеема
евхологий --- требник
жалование --- действие жалующегося, жалоба, печаль, сетование
жалостивно --- жалобно
жалощами --- жалостно
жалощи --- жалость, горе
жаль --- берег, 2. боль, печаль, 3. больница, могила, 3. жалко, жаль
жальник --- общие могилы в лесу для самоубийц и мертворожденных детей


-------
Number of things where an exception was: 5228, 5248, 5280, 5290
Date of logging it: 2021-02-05T03:15:13 (by the time in UA).
