Date of logging it: 2021-02-05T04:15:38 (by the time in UA).
-------
[6601-6700]
лежит --- надлежит, положено, назначено
лезье --- лезвие
лейки --- меры в корчмах
лемаргия --- гортанобесие
леитий --- полотенце
лен курящийся --- человек крайне слабый в духовно-нравственном отношении
лепта --- мелкая медная монета у евреев
лесо --- озеро, пруд
лестец --- прикорм, приманка; льстец, обманщик
лестно --- льстиво, обманчиво
лестне --- лукаво
лестчий --- обманчивый, обольстительный
лещи --- лечь
лжа --- ложь, неправда
лжеапостол --- самозванец, выдающий себя за апостола
лжебрат --- ненавистник, выдающий себя за друга
лжеглаголивый --- ложь говорящий, лгущий, врущий
лжеименитый --- ложно присваивающий себе имя
лжеклятие --- ложная клятва, неискренняя присяга
лжемонах --- самовольно ставший монахом без благословения и пострижения
лженадписан --- ложное надписание имеющий, например, указание на книге другого автора
лженевестная --- ложно почитаемая причастной браку
лжепатриарх --- самовольно объявивший себя патриархом
лжесвидетель --- лжесвидетель
лжесвященник --- самовольно объявивший себя священником без рукоположения епископа
лжесловесие --- ложные слова, ложь
лжесловник --- лжец, лгун, врун
лжехристианин --- притворный христианин, не исполняющий заповедей
лжехрист --- ложно выдающий себя за Христа
лжитель --- лжец, лгун, обманщик
лжица --- ложечка для причащения
ли --- или
а ли --- если, если же
аще ли --- неужели
либра --- имущество, деньги
лива --- южный или юго-западный ветер, 2. льющаяся влага, река
лив --- южный или юго-западный ветер
ликада --- луг
ливановый --- ладанный, благовонный
ливанский --- относящийся к Ливану, либо к ладану
Ливан --- Ливан, местность к западу от Палестины, 2. ладанное дерево, 3. ладан
ливел --- записная книжка, письмо, свидетельство
Ливия --- южная страна вообще
ливьц --- мастер, льющий монеты
лигем --- малокровный, анемичный
лигирий --- драгоценный желтоватый камень
лидаще --- если
Лидда --- город Лидда, или Диосполь
Лидия --- Лидия
Ликаония --- Ликаония, область Малой Азии
Ликиний --- Ликиний, император
Ликия --- Ликия, область в Малой Азии
ликовник --- участник хоровода
ликовне --- ликуя, с ликованием
ликовствование --- торжественное изъявление радости или веселья, ликование
ликую --- ликую, торжествую, веселюсь
ликонаставник --- предводитель хоровода
ликоначальник --- начальник лика
ликостояние --- чин блаженствующих, 2. стояние на церковной молитве
ликохожду --- прохожу торжественно
лилик --- птица нырок
лиман --- пристанище, пристань
лимонис --- цветник, книга патриарха Софрония
липки --- цветки липы
липса --- зараза, чума
липсати --- исчезать, умирать
лира --- лира, музыкальный инструмент
лиропод --- кривоногий
Лисаний --- Лисаний, зять Ирода Великого
Лисий Клавдий --- Лисий Клавдий, тысяченачальник, спасший ап. Павла от ярости иудеев
лискарь --- лопата, заступ
листопад --- ноябрь месяц
Листра --- Листра, город в Ликаонии
лиственный --- лиственный, состоящий из листьев
лис --- лис, лиса, лисица
лития --- лития, усердное моление в притворе храма
литица --- азбука
литон --- илитон, плат под антиминс
литра --- мера веса, 72 золотника
литургисание --- отправление св. литургии
литургисати --- литургию совершать
литургиарийон --- Служебник
литургия --- литургия
лихвовати --- обижать
лихвовение --- излишество, преступление
лихвоприятие --- взимание лихвы, взятка
лихий --- злой, лишний, непотребный
лихинтарь --- подсвечник
лихийа --- светильник, лампада
лихновати --- изобиловать, излишествовать
лихновьц --- дьявол
лихо --- зло, 2. злобно, бойко, проворно
лиховатися --- лишаться, недоставать
лиходей --- злодей


-------
Number of things where an exception was: 6654, 6658, 6665, 6678, 6681, 6691
Date of logging it: 2021-02-05T04:16:00 (by the time in UA).
