Date of logging it: 2021-02-05T04:16:00 (by the time in UA).
-------
[6701-6800]
лихоимство --- лихоимство, алчность, сребролюбие
лихом --- лишен
лихота --- злость, коварство, лукавство
лихоть --- неравенство
лихый --- лишний, 2. чрезвычайный, чрезмерный, превосходный, 3. лишенный, 4. печальный, злой, дурной
лицедей --- актер
лицезрительно --- лицем к лицу
лицемерие --- притворство, лицемерие
лицемеровати --- лицемерить
лиценачертание --- описание лица
лицы --- лик во множ. числе
личен --- пригож, красив, благообразен
личина --- маска
личити --- объявлять, делать вид
личник --- полотенце для лица, носовой платок
личба --- счёт, число
лишавый --- лишаями покрытый
лише --- лишь, только
лишевник --- ростовщик, лихоимец
лишенник --- вор, похититель, 2. бедняк, достойный жалости
лишенный --- погибший, отверженный, пропащий
лишше --- более
лишшеимец --- лихоимец
лишшеимение --- мздоимство, взяточничество
лифостротон --- каменный помост перед дворцом прокуратора в Иерусалиме
Лиа --- Лия, жена Иакова
лобзание --- поцелуй
лобный --- лобный
лобода --- лебеда
ловeц человеков --- апостол или проповедник Христов
ловитвенный --- относящийся к ловле
ловитель --- ловец, сидящий в засаде
ловительство --- сети, засада, козни
ловительствовати --- нападать внезапно из засады
ловище --- место ловли зверя и рыбы
ловление --- засада, 2. рыбная ловля, 3. ловчая сеть
ловос --- мочка уха
ловчий --- ловчий, охотник, 2. охотничий
логатай --- разведчик, лазутчик
логий --- велеречивый, красноречивый, 2. ветхий
логион --- наперсник или нагрудник ветхозаветного первосвященника
Логос --- Логос, Слово, Второе лицо Троицы
логофет --- секретарь при патриархе, хранитель печати
лог --- лощина
лодыга --- подножие
ложе --- постель, кровать, койка, ложе, 2. супружеское, брачное состояние, 3. русло реки
ложесна --- утроба, матка
ложный --- обманутый
ложчатый --- похожий на ложку
лоза --- виноградная лоза
лозина --- побег от пня или от корня
лозие --- виноградник
лозное делание --- разведение виноградных лоз, а также виноделие
лой --- растопленный жир
локати --- лакать
локва --- сильный дождь, ливень
локоть --- локоть, 2. мера длины - от локтя до конца среднего пальца
лома --- нить, волокно
ломлю --- ломаю, сокрушаю
лон --- кокосовый орех
лор --- пришелец
лось --- созвездие Большая Медведица
лошь --- дешёвый, плохой
Лот --- Лот, племянник Авраама
лотыга --- негодяй
лохань --- лохань, лоханка, таз
лощичие --- всякий огородный овощ
луда --- панцирь, доспехи, броня
лужный --- луговой
Лука --- Лука
лукавновати --- лукаво поступать, коварствовать
лукавомудрый --- мудрствующий с лукавством
лукавоухищрение --- лукавый умысел
лукование --- излучина, кривизна
луковати --- лукавствовать
лукути --- лукавить, хитрить
лук --- лук, оружие
лунитися --- лунатизмом страдать
луница --- ожерелье наподобие Луны
луновение --- ежемесячное женское недомогание
лунуюся --- лунатизмом страдаю
лутарь --- мешочек
лутовый --- лыковый
луча --- луч, заря
лучедатный --- озаряющий светом
лученосно --- освещая
лученосный --- льющий свет
лучица --- залив, заводь
лучшество --- изящество, превосходство
лщение --- приманка, прикорм для рыбы
лысто --- голень
лычница --- лапоть
львичищ --- львёнок
льзе --- можно
льнянище --- поле, бывшее под льном


-------
Number of things where an exception was: 6702, 6710, 6712, 6726, 6786
Date of logging it: 2021-02-05T04:16:23 (by the time in UA).
