Date of logging it: 2021-02-05T12:03:21 (by the time in UA).
-------
[7101-7200]
клюжати --- обличать
клюка --- приманка, хитрость, обман
клюн --- клюв
клюпотив --- болтливый
ключаемый --- согласный, приличный, удобный
ключаница --- засов, запор
ключарь --- ключник
ключеволхвование --- ворожба ключами
ключимный --- способный, полезный
ключимьство --- удобство, способность
ключися --- случилось
ключитися --- случиться, приключиться
ключно --- угодно
ключне --- сильно
кляпыш --- миндаль
клятися --- клясться, божиться, присягать
клячити --- становиться на колени, 2. нагибаться, 3. хромать
кмет --- крестьянин
кмотрство --- кумовство
кнафеов --- относящийся к валянию сукна
кнея --- кувшин
книговводитель --- законоучитель, законник
книгоположница --- библиотека, книгохранилище
книгочия --- учёный человек вообще
книжество --- учёность
книжица --- книжка, книжечка, 2. письмо, записка
книмиды --- сапоги, туфли, обувь
княжение --- область, управляемая князем, 2. время управления княжеством
княжий --- начальный, главный, 2. принадлежащий князю
кобел --- ковш
кобление --- волхвование по полёту и голосу птиц
кобь --- гадание по приметам
ковальница --- кузница
ковачество --- кузнечное мастерство, реже - слесарное мастерство
ковач --- кузнец
ковкал --- бокал, чаша
коврига --- круг, круглый хлеб
коврижка --- коврижка, хлебец
ков --- козни, злой умысел, мятеж
ковма --- равно
ковьник --- мятежник, злоумышленник
ковыль --- ковыль, степная трава
коган --- титул владык хазарских и алтайских
когда --- когда, в какое время
кодикел --- добавление к завещанию
кодола --- верига
кодрант --- мелкая медная монета
кожа --- кожа
кождо --- каждый
кожный --- кожаный
кожаный --- кожаный
козари --- хазары
козица --- музыкальный инструмент
козичина --- козья шкура, 2. козлятина
козичный --- сделанный из козьей шкуры
козлогласно --- противно звучаще
козлогласование --- бесчинная пирушка
кознодей --- козни творящий, хитрец, лукавец
кознодейство --- коварный замысел и поступок
кознольстивый --- лестный и при этом вредящий другому
кознствовати --- хитрить, козни строить
кознь --- навет, коварство, хитрость, козни
козьмось --- космос, вселенная, мир
кокот --- петух
кокош --- курица, наседка
кола --- повозка
колач --- калач, пирог
колебание --- шатание, дрожь, тряска, колебание
коледа --- коляда
колесница --- колесница, повозка
колесницегонитель --- колесницей правящий
колесничник --- кучер, погонщик, 2. едущий на колеснице
коли --- когда
колиба --- куща, палатка, шатёр
колибица --- шалашик, хижинка
колибник --- шатерник, изготовитель палаток
коливо --- сочиво
коликашти --- сколько раз
коликий --- сколь великий, сколь многий
коликощи --- сколько раз
колитва --- заклание, убиение
колиа --- яма, ров, колодец
коллегиат --- член собрания
коллегия --- коллегия, собрание
коллурий --- глазное лекарство
коло --- колесо, телега, 2. то, что лежит в основе движения
колобродити --- говорить не относящееся к делу, вертеться в словах наподобие колеса
коловорот --- водоворот
Колов --- Колов, подвижник Иоанн, обративший блаженную Таисию. Переводится как малорослый
Колоссы --- Колоссы, город во Фригии
колп --- дракон, змей, сирена
кольми --- во сколько более
кольми паче --- тем более
коле --- когда
коленоначатель --- старейшина племени


-------
Number of things where an exception was: 7110, 7132, 7141, 7188, 7193
Date of logging it: 2021-02-05T12:03:46 (by the time in UA).
