Date of logging it: 2021-02-05T12:03:46 (by the time in UA).
-------
[7201-7300]
коленопреклонение --- стояние на коленях во время молитвы
коленьник --- единоплеменник
комат --- кусок, ломоть
комит --- чиновник, собирающий дань царю, 2. градоначальник
комментарисий --- начальник над тюрьмами
комонь --- конь
комора --- казначейство, казнохранилище
коморг --- глиняный сосуд
комка --- причастие
комкальница --- чаша причастная
конархание --- исполнение должности канонарха
кондак --- кондак
кондит --- сбереженный
Кондратий --- Кондратий, Кондрат
кондер --- бокал
конегонитель --- извозчик, кучер, погонщик
конеристалище --- ипподром
конечно --- наконец
конкорданция --- согласие, соглашение
конник --- всадник
конобарь --- виночерпий
конобный --- котлам принадлежащий
конобь --- котёл, сковорода, противень
конористательный --- предназначенный для конского бега
коносый --- курносый
консисториа --- место для рассмотрения духовных дел епархии
Константинь --- Константинополь
консуларий --- имеющий или имевший консульское достоинство
конуры --- ладанки и обвязания для суеверных примет
конхила --- раковина
кончание --- окончание, конец
кон --- предел, начало, конец
конь --- конь, лошадь, 2. после, подле
коньник --- всадник
конюшский --- принадлежащий конюшему
копато --- копыто
копачьма --- виноградарь
копейник --- ратник, вооруженный копьём
копел --- незаконнорожденный
копити --- собирать, копить
копитися --- собираться, копиться
копие --- нож для резки просфор на проскомидии
копоруля --- челнок для ткания
копосати --- роскошествовать, блудодействовать
копошатися --- тереться, чесаться, возиться, копошиться
коприва --- крапива
копр --- укроп
копысати --- копытом бить или копать
копытити --- копыта иметь раздвоенные
копытьце --- башмаки
копьеносец --- оруженосец, телохранитель
копьеношу --- оруженосца службу выполняю
корабиец --- корабль, судно
корабленик --- корабельщик, 2. матрос, 3. мореплаватель
кораблец --- корабль, судно, лодка
корабль --- корабль, парусник
коравый --- толстокожий
корвана --- церковная казна
корван --- пожертвование в церковную казну
коргчий --- кормчий, 2. пастух
корг --- нос корабля
корд --- разновидность меча
Корей --- Корей
кореносекатель --- искоренитель, истребитель
кореносекательный --- служащий для искоренения
кореносечец --- искореняющий
корень --- начало, основа чего-л.
кореов --- Корею принадлежащий
коризна --- укор, укоризна, наказание
коринка --- сушёный виноград, разновидность изюма
Коринф --- Коринф
корити --- хулить, укорять, осуждать, стыдить
корифи --- верх, вершина
корица --- отроковица
кориандр --- кориандр
корка --- слиток серебра
корконосый --- курносый, реже - безносый
коркота --- судороги
корма --- корма
кормило --- руль управления кораблём
кормильствовати --- править, руководить
кормительство --- правление
кормити --- управлять
кормление --- правление, управление
кормлю --- кормлю молоком
кормля --- пища, снедь, еда
кормчая --- руководительница
кормчий --- кормчий, правящий кораблём
корносый --- имеющий вздёрнутый кверху короткий нос
коромысл --- весы
коронование --- торжественное венчание на царство
корсок --- сосуд, посудина
корста --- гроб, рака
корстица --- ковчежец
Корсунь --- Херсонес Таврический
корчаг --- кружка для вина
корчемник --- корчмарь
корчемница --- хозяйка корчмы, реже - сама корчма


-------
Number of things where an exception was: 7267, 7291
Date of logging it: 2021-02-05T12:04:10 (by the time in UA).
