Date of logging it: 2021-02-05T17:45:30 (by the time in UA).
-------
[7301-7400]
корчемствую --- продаю вино, 2. порчу, ослабляю
корчма --- корчма, кабак, шинок, питейный дом
корчмити --- корчму содержать
кор --- укор, оскорбление, обида, поношение
корда --- меч
корыстоватися --- пользоваться
корыто --- канал, корыто, водоём
корь --- кора
косен --- медлителен
коситер --- олово
косма --- кудри, волосы
косматица --- одежда из шерсти
космит --- украситель
космык --- украшение
коснити --- медлить, мешкать, медленно делать что-л.
косно --- медленно
косноглаголивый --- косноязычный, заика
косноязычен --- говорящий медленно
коснение --- медленность, медлительность, опоздание
косомер --- несправедливый судья или вельможа
косор --- коса, грабли
коста --- постоянный, твёрдый, непоколебимый
костань --- каштан
костарь --- игрок в кости
костел --- костел, католический храм
костельный --- костелу принадлежащий
костоголова --- череп
костоломный недyг --- ревматизм, боль в костях
костырь --- игрок в кости
кость --- кость, 2. жмых от оливок, винограда
костьр --- костер, 2. лагерь
кос --- попугай
котар --- предел, граница
котва --- якорь
котера --- спор, ссора, сражение
котин --- ястреб
кото --- кто
коток --- котик
котора --- ссора, распря
которати --- бранить, ругаться, ссориться
котыга --- платье вообще
котыгство --- пиршество, забавы
котьць --- цилиндр, каток, скалка, 2. клетка, окно
кохль --- улитка, раковина
кочт --- петух, кочет
кошара --- кошара, хлев
коштунати --- рассказывать сказки, басни
коштуньник --- шутник, забавник
кош --- корзина, короб
кощей --- измождённый худобой человек
кощуна --- святотатство
кощунание --- кощунство
кощуны --- забавные шутки
коюга --- колодка сапожника
кра --- льдина
крабия --- короб, ящик, тара, ковчег
крава --- корова, бык, вол
краварь --- пастух
крадлив --- склонный к воровству, кражам
крадобрачник --- совратитель чужих невест
крадьба --- кража, воровство
краду --- обманываю
краегранесие --- акростих
краенеобрезание --- отсутствие обрезания
краепытан --- исправный, обработанный, точный
краестрочие --- фразы из греческих букв на краях строк церковных книг
краесекомый --- обтёсанный
краеугольный --- находящийся на краю угла
крайняя плоть --- крайняя плоть
крак --- шаг, ход, голень
кралевство --- королевство
краль --- король
крамки --- капуста
крамоливый --- мятежный, сварливый
краниево место --- лобное место, Голгофа
крапленый --- крапчатый
крапля --- капля
красно --- сладкозвучно
красноглаголание --- умение говорить сладкозвучно, витиеватость
краснодушный --- добродетельный, благодушный
красноличный --- красивый лицом
краснолепный --- красивый, стройный
краснопеснивый --- певец
красование --- красота, а также всякая вещь, обращающая на себя внимание красотой
красовул --- чаша для питья в греческих монастырях
красотодетель --- поэт, певец
красотный --- составляющий красоту
краста дивия --- кожные заболевания
краставый --- паршивый
краткоглаголивый --- изображаемый в кратких словах, 2. изъясняющий немногими словами
кратир --- чаша, кубок, 2. бассейн, водоём, где вода бьет ключом или фонтаном
краты --- хорошая мера, удобное время
крач --- бой, битва, спор, вражда
крашу --- украшаю
крашуся --- украшаюсь, красуюсь, 2. наслаждаюсь, увеселяюсь
краще --- короче


-------
Number of things where an exception was: 7320, 7355, 7377, 7389
Date of logging it: 2021-02-05T17:45:59 (by the time in UA).
