Date of logging it: 2021-02-05T17:45:59 (by the time in UA).
-------
[7401-7500]
крелина --- крыло
крестуемый --- распинаемый на кресте
крестилище --- место для крещения
купель --- купель, где крестят младенцев
Креститель --- Креститель, относится только к Иоанну Предтече
крестобогородичен --- стих о Честном Кресте и Пресвятой Богородице
крестоводружение --- поставление креста при заложении нового храма
крестовоскресен --- стих о распятии Христовом и Воскресении
крестоненавистник --- враг креста, христианской веры
крестоносица --- видящая защиту и надежду в Кресте Господнем, 2. терпеливо несущая свой крест
крестоносно --- неся крест
крестообразно --- наподобие креста
крестоявленно --- являя образ Креста, 2. крестообразно
крестоявленный --- крестовидный, крестообразный
крест --- крест
крестьцы --- крестчатая резьба, узорчатая решётка
кречелы --- дровни, телега
кречет --- кречет, вид сокола
кривица --- вина, поступок, преступление
кривоверие --- ересь, раскол
кривосудие --- несправедливое судебное решение
кривотолки --- раскольники, неправильно толкующие св. Писание
кривый --- неправый
кривьц --- виновник, ответчик в суде
криж --- крест
крилолучный --- крыльями лучам подобный
крина --- хлебная мера
криница --- источник
крин --- лилия
кринов --- лилейный
крипида --- ступень, вход
Крит --- Крит, остров, 2. сокровищница, хранилище
кричава --- крик, вопль
кровать --- кровать, одр, постель, носилки
кровля --- кровля, крыша
кровомешство --- инцест, кровосмешение
кровопийца --- кровопийца, мучитель, тиран, немилосердный, бесчеловечный, деспот
Канслир --- Дьяк
Канун --- Кутья и питье для поминовения усопших
Каноура --- Род амулета или талисмана
Каплан --- Католический священник
Каплица --- Католическая часовня
Капоноша --- Носящий шапку
Каптана --- Зимний экипаж на полозьях
кровопиявый --- алчущий крови
кровопролитие --- пролитие крови при заклании жертвенных животных
кровосмешение --- инцест, кровосмешение
кровотечение --- кровотечение
кровоточивый --- истекающий кровью, 2. больной гемофилией
кровоядец --- кровопийца, кровожадный
кровь --- кровь, жизнь, сок, сукровица
кроение --- рана, язва
крока --- уток, ткань
крозе --- чрез, сквозь
кроило --- меч, нож, резец
кроковатый --- развесистый
крома --- край, кромка, кусок
кропа --- капля
кропление --- орошение
кросно --- навой, ткань
кротафи --- виски
кротомый --- отколотый
кротор --- антонов огонь
кротостный --- кроткий
кротость --- кротость, иногда - слабость, изнеможение
крочитися --- корчиться
крошка --- корзина
кроще --- сокровище
кроюся --- делаю насечки на теле по суеверному языческому обычаю
круг --- круг, период богослужений (суточный круг, годичный круг)
кружало --- окружение
кружило --- кружево
крепко --- крепко, твёрдо, неуклонно
крепкодушный --- крепкий дух имеющий
крепкомудренный --- непоколебимый в разуме
крепкостоятельный --- крепкий, твёрдый
крепкоуздный --- осёдланный в узду с мундштуком
креплий --- крепчайший, сильнейший, превосходнейший
крепостный столп --- столп внутри здания, несущий основную нагрузку
кресение --- воскресение
кресити --- воскресити
кристалловидный --- хрусталю подобный видом
кристальный --- хрустальный
ксанфик --- месяц македонского календаря
ксенодох --- странноприимец
ксилолой --- алойное дерево
ктитор --- церковный староста
кувикуларий --- постельничий при царском дворе
кудельный --- льняной или пеньковый


-------
Number of things where an exception was: 7403, 7406, 7419, 7424, 7442, 7444, 7463, 7475, 7498, 7499, 7500
Date of logging it: 2021-02-05T17:47:34 (by the time in UA).
