Date of logging it: 2021-02-05T20:11:09 (by the time in UA).
-------
[7601-7700]
маль --- молоток
мальжа --- супруга
мальжен --- супруг
мама --- мама, мамка, матушка, воспитательница
Мамврийский дyб --- Мамврийский дyб, под которым состоялось видение Троицы Аврааму
мамити --- обманывать
маммона --- богатства, имение, земные блага
мам --- глупый
манаа --- дар, жертвоприношение
Манассия --- Манассия, старший сын патриарха Иосифа
мандия --- малая схима
мандра --- ограда, овчарня, монастырь
мандрагора --- мандрагора
мандрагоровый --- относящийся к мандрагоре
манзер --- мастер, делающий стеклянную посуду
мани --- исчисли
манити --- манить, привлекать, обманывать
манна --- манна
маннодавец --- податель манный
манноносный --- носящий в себе манну
манноподаяти --- манну ниспосылать
манноприемный --- хранящий в себе манну
мановение --- мания, склонность, вдохновение, склонение
Маное --- отец Сампсона
мантийца --- небольшая мантия для покрытия плеч
мантия --- мантия, верхняя одежда, епанча, монашеское одеяние
мара --- обморок, потеря сознания
марагд --- изумруд
маранафа --- да будет отлучен и да погибнет в пришествие Господне
Маргарит --- книга Иоанна Златоуста
Мардохей --- Мардохей, дядя Есфири
Мариа --- Мария
Мариамна --- жена Ирода Великого, им убитая
Мариам --- Мариам
маркиониты --- маркиониты, еретическая секта
маркианиты --- маркианиты, еретики докетского толка
Марковы главы --- Марковы главы, устав на службу великого поста
Марк --- Марк
марониты --- марониты, еретики
мартириане --- мартириане, еретики, то же что мессалиане
мартиролог --- сборник сказаний о св. мучениках
мартолос --- грабитель, разбойник
март --- март
маслина --- маслина, оливковое дерево
масса --- вода пререкания
мастило --- чернила
мастительный --- масляный
мастити --- красить, намазывать
мастороматоносный --- приносящий благовонные масла
мастропа --- гадальщица
материзна --- наследство после матери
материца --- тёща
матерны --- скверными, срамными, бранными словами
матеродевственный --- относящийся к матери и деве, т.е. к Пресвятой Богородице
матеролепно --- как мать
матеролепне --- матерински, как подобает матерям
матерский --- материнский
матерь градовом --- столица, главный город
матерею --- матерею, твердею, вырастаю (о деревьях), огрубляюсь
мати --- мать
матица --- начало, основа, 2. компас, магнит
Маттафия --- Маттафия
Матфей --- Матфей, Левий, мытарь, евангелист, один из 12 апостолов
Матфий --- Матфий, апостол, избранный в число 12 взамен отпавшего Иуды
Маханаим --- Маханаим, местность за Иорданом
Махерус --- Махерус, Махерон, крепость
Махпела --- Махпела, пещера, купленная Авраамом
махомь --- необдуманно
машитися --- обрушиваться, валиться
мачеха --- мачеха, неродная мать
мащу --- жирным делаю
Мафусал --- Мафусал, Мафусаил, библейский патриарх, прожил 969 лет
мгла --- тьма, туман, облако
мгляный --- мглою окруженный или покрытый
мгновeние ока --- мгновeние ока
Мегиддон --- Мегиддон, крепость
медвеяный --- медовый
медимн --- аттическая мера вместимости - 2 четверика
медленноязычный --- заикающийся
медливый --- медлительный, непроворный, медленный
медозлатый --- прозвание св. Златоуста
медоточный --- мед источающий
медоязычный --- сладкоречивый
мед дивий --- мёд дикий
мед и млеко --- молоко и мед - символ изобилия
межа --- предел, граница, промежуток, межа
междорамие --- пространство между плечами, спина
междоречие --- Междуречье, Месопотамия, 2. селение между реками
междочасия --- службы, совершающиеся между службами часов
междустолпие --- галерея, пространство между колоннами
междю --- между
межина --- площадь


-------
Number of things where an exception was: 7608, 7609, 7647, 7660, 7664, 7666, 7673, 7694
Date of logging it: 2021-02-05T20:11:49 (by the time in UA).
