Date of logging it: 2021-02-05T21:14:31 (by the time in UA).
-------
[7801-7900]
мировати --- мирно жить
мировожделенный --- желающий мира, любящий мир
миродарный --- умиротворяющий, дающий мир, тишину
миродaтельница --- подательница мира, спокойствия
мироименитый --- имя мира носящий, например, Ирина
мироначальник --- начало, податель мира
миродательне --- умиротворяя, подавая мир
мирра --- смирна
мирсина --- мирт
мирствую --- мирно живу
миса --- месса, литургия католиков, 2. дискос, блюдо, 3. чаша для похлёбки
Мисаил --- Мисаил
Мисир --- Египет
Мисия --- Мисия, страна, смежная с Фракией
мисор --- равнина
Митилeна --- Митилeна, город на острове Лесбос
митовати --- топтать, наступая ногами поочерёдно
митра --- митра, головной убор архиерея
митрополит --- митрополит
мите --- попеременно
михана --- осадная, стенобитная машина
Михeй --- Михeй, пророк
миробогатый --- пребогатый
миробытие --- миротворение, миросоздание
миродержание --- пристрастие к мирским чувствам
Миродержец --- правитель Вселенной, т.е. Бог, иногда так называют Дьявола
миродержитель --- иногда так называют Дьявола
миролюбезный --- любящий мирское
миролюбный --- пристрастный к мирскому
миросветлый --- светящий миру
мироспасительный --- миродвижитель
мироявленный --- показываемый всем
мирский князь --- дьявол
мирстии концы --- крайние пределы земли
миряне --- миряне, светские люди
младенечный --- младенческий
младенствую --- нахожусь в детском возрасте
младина --- младенец
младица --- девочка-младенец
младовати --- поступать по-детски
младодеяти --- принимать образ младенца, облекаться во плоть
младок --- прут, гибкая ветвь
младоносити --- носить младенца во чреве
младоноситися --- находиться в утробе матери
младопитательница --- кормилица младенца
младость --- мягкость, нежность
младоумие --- неосновательный, незрелый ум
млатити --- молотить
млатобиец --- кузнец, молотобоец
млат --- молот, кувалда
млеко --- молоко, 2. млечный сок растений
млекопитaтельница --- кормилица, кормящая мать
млекопитaю --- кормлю грудью
млин --- блин, опреснок
млохавьство --- слабость
млыхи --- узда
мнас --- мина, монета
мнихолюбивый --- чтящий чин иноческий
мних --- инок, чернец, монах
мнишка --- инокиня, монахиня
мнишеский --- монашеский
мний --- меньший, младший
многажды --- многократно, много раз
многобезсловeсие --- крайнее невежество
многоблагоутробный --- весьма милосердный
многобогaтый --- очень драгоценный
многобожница --- языческий храм, пантеон
многоболезненный --- бедственный, очень скорбный, тяжкий
многобурный --- многомятежный
многобедный --- исполненный многих бед
многовидный --- многообразный
многовожделенный --- очень желаемый
многовоздыхати --- воздыхать много
многоволненный --- волнуемый сильно
многовонный --- очень пахучий
многоврачебный --- дающий многие исцеления
многовременный --- долговременный, закоренелый
многовредьн --- обладающий многими страстями
многовздыхальн --- много сетующий
многовечьн --- долговечный, продолжительный
многовещанный --- многоречивый, говорливый
многоглаватый --- имеющий много глав, разделяющийся на многие отделения
многогласный --- многоголосый, поющий различными голосами
многогобзенный --- весьма изобильный
многогробищный --- имеющий много гробов или могил
многогубо --- многократно, премного, разнообразно
многогубый --- многократный
многодaрный --- дающий много даров
многоденствити --- испрашивать долгие дни или продолжительную жизнь
многодeнствовати --- наградить долгой жизнью
многодей --- великолепие, пышность, величие души, 2. высокопарность, хвастовство
многожeнство --- многожeнство
многоименитый --- имеющий много имён


-------
Number of things where an exception was: 7808, 7825, 7844, 7846, 7868, 7869, 7873
Date of logging it: 2021-02-05T21:16:23 (by the time in UA).
