Date of logging it: 2021-02-05T21:17:46 (by the time in UA).
-------
[8001-8100]
мнук --- внук
мнее --- менее, меньше
моавитяне --- моавитяне
Моав --- Моав, родоначальник моавитян
Моамеф --- Магомет
мовь --- баня
Могар --- Могар, путешественник
могyтник --- сильный, могучий человек
могyтный --- мощный, могучий, сильный, всемогущий
могyтство --- мощь, всемогущество
могыла --- могила, курган
Модaд и Елдaд --- старейшины-прорицатели
модр --- синеватый
модретися --- темно-синим казаться
можжевeльник --- можжевeльник
Моисей --- Моисей
мокрадь --- болото
мокротворный --- вода или иная жидкость, чем можно замочить
Мокша --- Мокша, идол
молебен --- богослужение, совершаемое по особой нужде
молебник --- книга с текстами молебнов
молебница --- часовня, молельня, здание для молитв
молебно --- годично, ежегодно
молeбный --- моление содержащий
молебствие --- всенародное моление по какому-л. случаю
молитвенник --- книга с текстами молитв
молитвенница --- храм, предназначенный для молитв Богу, 2. угодница Божия, ходатайствующая за нас
молитвоелей --- елеосвящение
молитвенный --- вожделенный
молитвити --- молиться
молитвомаслие --- елеосвящение
молитвословие --- молитва, собрание молитв
молитвослов --- молитвенник, книга с текстами молитв
молити --- молить, служить, просить, ходатайствовать, исполнять должность посла или ходатая
молица --- мякоть дерева, источенная червями
молие --- моль
молниезрачный --- вид молнии имеющий
Молох --- языческое божество аммонитян
молчание --- иногда означает невнимание, пренебрежение
молчальник --- молчун, говорящий редко и мало, 2. святой, избравший подвиг молчания
молчaльница --- монашеская келья на одного человека
молчaльствовати --- жить уединённо, отшельничать
молчу --- молчу, перестаю, успокаиваюсь, отступаю
мольба --- мольба, прошение, просьба, ходатайство
молюся --- обет даю
мома --- девушка, молодая женщина, дочь
мом --- нёбо (во рту)
монарх --- монарх, единоначальник, единовластитель, самодержец
монаршески --- самодержавно, единовластно
монастырь --- монастырь
монах --- монах
монашествую --- монашествую
монистный --- состоящий из монист
монисто --- ожерелье
моногамия --- единобрачие
Мономах --- единоборец, а также имя некоторых царей
Мономаш --- сын греческого царя Мономаха
монофелиты --- монофелиты, еретики
монтанисты --- монтанисты, еретики
Монтан --- Монтан, основатель ереси монтанизма
мокос --- крот
мора --- волшебница
мордати --- кривляться, гримасничать
мордка --- денежная единица
море --- море
морити --- морить, изнурять, умерщвлять, убивать
Мориа --- Мориа, гора
мор --- мор, повальная смертность, 2. шелковая ткань пополам с золотой или серебряной
Мосох и Фовeл --- имена сыновей Иафета
мостный --- мосту принадлежащий
мотыка --- лопата, мотыга, заступ, скребок
мотыло --- кал
мочало --- мочало, волокна из липовой коры
мочь --- моча, 2. могущество, сила, 3. возможность
мощен --- могучий, сильный, мощный
мощи --- останки святых
могу --- могу
мощно --- можно
мощь --- сила, мощь
мравин --- муравьиный
мравий --- муравей
мраволев --- муравьиный лев, 2. старый лев
мразити --- ненавидеть
мраз --- мороз, стужа
мрак --- мрак, темнота
мрежеплетeнный --- устроенный наподобие мрежи - сети для ловли зверей
мрежник --- рыбак
мругати --- моргать
мрша --- труп
мршав --- худой, тощий
мска --- мул, лошак
мскус --- мускус
мста --- мост, 2. молодое свежее вино


-------
Number of things where an exception was: 8016, 8038, 8040, 8063, 8066, 8070, 8100
Date of logging it: 2021-02-05T21:19:07 (by the time in UA).
