Date of logging it: 2021-02-05T21:20:25 (by the time in UA).
-------
[8201-8300]
мя --- меня
мягкий --- мягкий, нежный, молодой
мягкосветлый --- богатый, нарядный, великолепный (об одеянии)
мягкость --- корпия, нитки для покрытия ран
мясная неделя --- всеядная неделя
мясопустная неделя --- воскресный день перед Масленицей
мясосечница --- бойня
мясоядение --- приём мясной пищи
мясоястие --- мясоед, время разрешения на приём мясной пищи
мятва --- мята
мятуся --- огорчаюсь сильно, скорблю, терзаюсь, мучаюсь
мигал --- ящерица или еж
миризма --- запах
Мирликийский чудотворец --- св. Николай, Мирликийский чудотворец
мироблагоухати --- испускать приятный запах, подобный миру
мироварение --- приготовление мира
мироварный --- относящийся к приготовлению мира
мировати --- миром помазывать
мировоние --- благоухание, исходящее от мира
мировонный --- благовонный, пахнущий миром
мироносица --- сосуд, в котором хранится миро, 2. благочестивые жены, пришедшие для помазания Христа во гробе
мирон --- смирна
мироположница --- мирохранилище
миропомазание --- миропомазание
мироприятный --- служащий для принятия и хранения мира
миропродавница --- место продажи благовонных масел
миротечение --- истечение мира
мироточец --- источающий чудотворное миро
мироухаю --- издаю запах мира
мирсина --- мирт
Миры --- Миры, город, прославленный служением св. Николая Чудотворца
набадати --- колоть
набат --- военный барабан
набдеваю --- храню
набедренник --- набедренник, часть облачения священника
набедрьница --- платочек, салфетка
наблом --- музыкальный инструмент типа арфы
Набопалассар --- Набопалассар, отец Навуходоносора
Навав --- Навав, гора
навада --- привычка, обыкновение
наваждаю --- наущаю, науськиваю
Навал --- Навал, помогал Давиду
навальность --- колебание, нерешительность
наведение --- нападение
навершаемый --- содействующий, 2. приводимый в исполнение, в совершенство
навершати --- исполнять, вознаграждать, навёрстывать
навечение --- канун праздника
навклир --- хозяин или начальник корабля
навой --- противоположно
наволок --- мыс
наворопити --- нападать, напасть
навращати --- приводить в первобытное состояние
Навузардан --- Навузардан, начальник телохранителей Навуходоносора
Навуходоносор --- Навуходоносор
Навофей --- Навофей, израильтянин, убитый Ахавом
навыкаю --- узнаю
навыкновение --- привычка, навык
навычение --- обучение
навычный --- навык имеющий, умелый, искусный, знающий
навеждати --- посещать, навещать
наветие --- козни, наветы, ухищрения
наветливый --- наветам подверженный, склонный к козням
наветник --- изменник
наветный --- исполненный козней
наветование --- наговор, клевета, поношение
наветоватися --- оклеветанным быть
нагбенный --- нагнутый
нагвоздити --- гвоздями набить
нагев --- юг, южная страна
наглавие --- митра, кидар, головной убор царя или первосвященника
наглашение --- оглашение, катихизис
наглити --- возбуждать, торопить, подстрекать
нагло --- скоро, отчаянно
наглодушен --- яр, вспыльчив
наглодушие --- запальчивость
наголе --- на голой земле, без подстилки
нагорбити --- сгорбиться, свернуться
нагота --- нагота, обнажение, 2. лишение, бедность
наготствую --- хожу без одежды
нагот --- оникс
нагробок --- надгробная надпись
нагромождaти --- нагромождать, сваливать в кучу или стопку
нагрудник --- наперсник
наг --- нагой, обнаженный, без одежды, 2. срамной
нада --- надо
надальн --- далёкий, отдалённый, 2. долгий
надати --- сносить в одно место
надворьн --- придворный, дворцовый
надебельн --- толстоватый
надлежит --- следует, надлежит, 2. полезно, служит на пользу, 3. лежащий на чем-л.
надклонитися --- нависнуть, наклониться, нагнуться
наднебесный --- горний
надникнути --- нагнуться, наклониться
надоносимый --- носящий поверх чего-л.
надо --- надо, нужно


-------
Number of things where an exception was: 8221, 8222, 8231, 8232, 8284
Date of logging it: 2021-02-05T21:21:39 (by the time in UA).
